ínàÊÉRÅ[Éh,ínàÊéØï ÉRÅ[Éh,,êlå˚Å@ïΩê¨27îN,êlå˚Å@ïΩê¨22îNÅiëgë÷Åj,ïΩê¨22îNÅ`27îNÇÃêlå˚ëùå∏êî,ïΩê¨22îNÅ`27îNÇÃêlå˚ëùå∏ó¶ÅiÅìÅj,ñ êœÅikm2Åj 1),êlå˚ñßìxÅi1km2ìñÇΩÇËÅj 2),ê¢ë—êîÅ@ïΩê¨27îN,ê¢ë—êîÅ@ïΩê¨22îNÅiëgë÷Åj,ïΩê¨22îNÅ`27îNÇÃê¢ë—ëùå∏êî,ïΩê¨22îNÅ`27îNÇÃê¢ë—ëùå∏ó¶ÅiÅìÅj
0,a,ëSçë,127110047,128057352,-947305,-0.739750577,377972.28,340.8,53403226,51950504,1452722,2.796357856
1,b,ésïî,116149227,116549098,-399871,-0.343092316,216974.68,535.5,49277163,47812998,1464165,3.062273987
2,b,åSïî,10960820,11508254,-547434,-4.756881452,160913.85,70.3,4126063,4137506,-11443,-0.276567575
1000,a,ñkäCìπ,5383579,5506419,-122840,-2.23085094,83424.22,68.6,2440502,2424317,16185,0.667610713
1001,b,ésïî,4396822,4449360,-52538,-1.180799036,18536.19,238.4,2017391,1989236,28155,1.415367508
1002,b,åSïî,986757,1057059,-70302,-6.650716753,64829.02,16.5,423111,435081,-11970,-2.751211843
1100,1,éDñyés,1953784,1913545,40239,2.102850991,1121.26,1742.5,919198,885848,33350,3.764754224
1101,0,éDñyés íÜâõãÊ,237784,220189,17595,7.990862396,46.42,5122.4,131598,120741,10857,8.991974557
1102,0,éDñyés ñkãÊ,285432,278781,6651,2.385743648,63.57,4490,133522,127440,6082,4.772441934
1103,0,éDñyés ìåãÊ,262075,255873,6202,2.423858711,56.97,4600.2,124424,118939,5485,4.611607631
1104,0,éDñyés îíêŒãÊ,209770,204259,5511,2.698045129,34.47,6085.6,103548,100444,3104,3.090279161
1105,0,éDñyés ñLïΩãÊ,218792,212118,6674,3.146361931,46.23,4732.7,109439,107179,2260,2.108622025
1106,0,éDñyés ìÏãÊ,141358,146341,-4983,-3.405060783,657.48,215,61197,62776,-1579,-2.515292469
1107,0,éDñyés êºãÊ,213822,211229,2593,1.227577653,75.1,2847.2,97677,96421,1256,1.302620798
1108,0,éDñyés å˙ï ãÊ,127826,128492,-666,-0.518320207,24.38,5243.1,55540,54099,1441,2.663635187
1109,0,éDñyés éËàÓãÊ,141061,139644,1417,1.014723153,56.77,2484.8,57206,55050,2156,3.9164396
1110,0,éDñyés ê¥ìcãÊ,115864,116619,-755,-0.647407369,59.87,1935.3,45047,42759,2288,5.350920274
1202,2,îüäŸés,266117,279127,-13010,-4.660960781,677.83,392.6,123968,126180,-2212,-1.753051197
1203,2,è¨íMés,121910,131928,-10018,-7.593535868,243.83,500,55266,57711,-2445,-4.236627333
1204,2,àÆêÏés,339797,347095,-7298,-2.102594391,747.66,454.5,155756,154393,1363,0.882812045
1205,2,é∫óñés,88585,94535,-5950,-6.293965198,80.88,1095.3,43552,45029,-1477,-3.280108375
1206,2,ã˙òHés,174804,181169,-6365,-3.513294217,1362.92,128.3,82111,81015,1096,1.352835895
1207,2,ë—çLés,169389,168057,1332,0.792588229,619.34,273.5,77679,75474,2205,2.921535893
1208,2,ñkå©és,120652,125689,-5037,-4.007510602,1427.41,84.5,55569,56012,-443,-0.79090195
1209,2,ó[í£és,8845,10922,-2077,-19.01666361,763.07,11.6,4526,5558,-1032,-18.56783015
1210,2,ä‚å©ëÚés,84541,90145,-5604,-6.216650951,481.02,175.8,36156,36723,-567,-1.543991504
1211,2,ñ‘ëñés,38966,40998,-2032,-4.956339334,471,82.7,17984,18112,-128,-0.706713781
1212,2,óØñGés,22227,24457,-2230,-9.118043914,297.83,74.6,10399,11044,-645,-5.840275263
1213,2,ìœè¨ñqés,172794,173320,-526,-0.303484884,561.57,307.7,78229,76289,1940,2.542961633
1214,2,ítì‡és,36399,39595,-3196,-8.071726228,761.49,47.8,16501,17343,-842,-4.85498472
1215,2,î¸âSés,23048,26034,-2986,-11.46961666,277.69,83,10175,10992,-817,-7.432678312
1216,2,à∞ï és,14686,16628,-1942,-11.6790955,865.04,17,6858,7526,-668,-8.875896891
1217,2,ç]ï és,120677,123722,-3045,-2.46116293,187.38,644,51932,51170,762,1.489153801
1218,2,ê‘ïΩés,11097,12637,-1540,-12.18643665,129.88,85.4,4947,5585,-638,-11.42345568
1219,2,ñ‰ï és,23080,24750,-1670,-6.747474748,830.78,27.8,11095,11390,-295,-2.58999122
1220,2,émï és,19930,21787,-1857,-8.523431404,1119.22,17.8,8655,9100,-445,-4.89010989
1221,2,ñºäÒés,29060,30591,-1531,-5.004739956,535.2,54.3,13083,13348,-265,-1.985316152
1222,2,éOä}és,9080,10221,-1141,-11.16329126,302.52,30,4225,4776,-551,-11.53685092
1223,2,ç™é∫és,26919,29201,-2282,-7.814800863,506.25,65.4,11376,11897,-521,-4.379255274
1224,2,êÁçŒés,95664,93604,2060,2.200760651,594.5,160.9,40614,38541,2073,5.378687631
1225,2,ëÍêÏés,41209,43170,-1961,-4.54250637,115.9,355.6,18631,18947,-316,-1.667810207
1226,2,çªêÏés,17702,19056,-1354,-7.105373636,78.68,225,7870,8415,-545,-6.476530006
1227,2,âÃéuì‡és,3587,4387,-800,-18.23569638,55.95,64.1,1667,2000,-333,-16.65
1228,2,ê[êÏés,21934,23709,-1775,-7.486608461,529.42,41.4,9695,10100,-405,-4.00990099
1229,2,ïxó«ñÏés,22947,24259,-1312,-5.408302074,600.71,38.2,9928,10074,-146,-1.449275362
1230,2,ìoï és,49656,51526,-1870,-3.629235726,212.21,234,21682,21717,-35,-0.161164065
1231,2,åbíÎés,69745,69384,361,0.520292863,294.65,236.7,28612,27634,978,3.539118477
1233,2,à…íBés,35026,36278,-1252,-3.451127405,444.21,78.9,15051,15287,-236,-1.543795382
1234,2,ñkçLìáés,59087,60353,-1266,-2.097658774,119.05,496.3,23561,22991,570,2.479231003
1235,2,êŒéÎés,57462,59449,-1987,-3.342360679,722.42,79.5,22426,22603,-177,-0.783081892
1236,2,ñkìlés,46416,48032,-1616,-3.364423718,397.44,116.8,18414,18412,2,0.010862481
1300,c,êŒéÎêUãªã«,20622,22281,-1659,-7.445805844,500.89,41.2,8392,8486,-94,-1.107706811
1303,3,ìñï í¨,17290,18766,-1476,-7.865288287,422.86,40.9,7327,7400,-73,-0.986486487
1304,3,êVé¬í√ë∫,3332,3515,-183,-5.206258891,78.04,42.7,1065,1086,-21,-1.933701658
1330,c,ìnìáëççáêUãªã«,92454,100648,-8194,-8.141244734,2862.11,32.3,39289,40887,-1598,-3.908332722
1331,3,èºëOí¨,7336,8748,-1412,-16.14083219,293.25,25,3563,3959,-396,-10.00252589
1332,3,ïüìáí¨,4423,5114,-691,-13.51192804,187.28,23.6,2039,2194,-155,-7.064721969
1333,3,ímì‡í¨,4654,5074,-420,-8.277493102,196.75,23.7,2004,2009,-5,-0.24888004
1334,3,ñÿå√ì‡í¨,4545,5341,-796,-14.90357611,221.87,20.5,2140,2317,-177,-7.639188606
1337,3,éµî—í¨,28130,28463,-333,-1.169939922,216.75,129.8,11045,10891,154,1.414011569
1343,3,é≠ïîí¨,4227,4767,-540,-11.32787917,110.64,38.2,1659,1675,-16,-0.955223881
1345,3,êXí¨,15950,17859,-1909,-10.68928831,368.79,43.2,6629,7103,-474,-6.673236661
1346,3,î™â_í¨,17262,18896,-1634,-8.647332769,956.02,18.1,7529,7892,-363,-4.599594526
1347,3,í∑ñúïîí¨,5927,6386,-459,-7.18759787,310.76,19.1,2681,2847,-166,-5.830698981
1360,c,ûwéRêUãªã«,37863,42058,-4195,-9.974321176,2630.29,14.4,16821,17927,-1106,-6.169465053
1361,3,ç]ç∑í¨,8239,9004,-765,-8.496223901,109.53,75.2,3748,3968,-220,-5.544354839
1362,3,è„Émçëí¨,4869,5428,-559,-10.29845247,547.71,8.9,2175,2307,-132,-5.721716515
1363,3,å˙ëÚïîí¨,4055,4409,-354,-8.029031526,460.58,8.8,1764,1868,-104,-5.56745182
1364,3,â≥ïîí¨,3905,4408,-503,-11.41107078,162.59,24,1730,1863,-133,-7.139023081
1367,3,âúêKí¨,2693,3033,-340,-11.21002308,142.97,18.8,1274,1364,-90,-6.598240469
1370,3,ç°ã‡í¨,5631,6186,-555,-8.971871969,568.25,9.9,2280,2388,-108,-4.522613065
1371,3,ÇπÇΩÇ»í¨,8471,9590,-1119,-11.66840459,638.66,13.3,3850,4169,-319,-7.65171504
1390,c,å„éuëççáêUãªã«,93626,101012,-7386,-7.312002534,4062.05,23,42536,44120,-1584,-3.590208522
1391,3,ìáñqë∫,1495,1781,-286,-16.05839416,437.18,3.4,658,742,-84,-11.32075472
1392,3,éıìsí¨,3136,3443,-307,-8.916642463,95.24,32.9,1427,1536,-109,-7.096354167
1393,3,çïèºì‡í¨,3082,3250,-168,-5.169230769,345.65,8.9,1338,1353,-15,-1.10864745
1394,3,óñâzí¨,4843,5292,-449,-8.484504913,449.78,10.8,2093,2129,-36,-1.690934711
1395,3,ÉjÉZÉRí¨,4962,4823,139,2.882023637,197.13,25.2,2270,2054,216,10.51606621
1396,3,ê^éÎë∫,2108,2189,-81,-3.700319781,114.25,18.5,851,867,-16,-1.84544406
1397,3,óØéıìsë∫,1905,2034,-129,-6.342182891,119.84,15.9,915,883,32,3.62400906
1398,3,äÏñŒï í¨,2291,2490,-199,-7.991967872,189.41,12.1,1130,1207,-77,-6.37945319
1399,3,ãûã…í¨,3187,3811,-624,-16.37365521,231.49,13.8,1281,1740,-459,-26.37931034
1400,3,ã‰ímà¿í¨,15024,15568,-544,-3.494347379,261.34,57.5,6971,7102,-131,-1.844550831
1401,3,ã§òaí¨,6233,6428,-195,-3.033602987,304.91,20.4,2854,2698,156,5.782060786
1402,3,ä‚ì‡í¨,13041,14451,-1410,-9.757110235,70.6,184.7,6239,6555,-316,-4.820747521
1403,3,îëë∫,1763,1883,-120,-6.372809347,82.28,21.4,887,855,32,3.742690059
1404,3,ê_åbì‡ë∫,1004,1122,-118,-10.51693405,147.8,6.8,434,473,-39,-8.245243129
1405,3,êœíOí¨,2113,2516,-403,-16.01748808,238.14,8.9,1000,1175,-175,-14.89361702
1406,3,å√ïΩí¨,3188,3611,-423,-11.71420659,188.36,16.9,1463,1588,-125,-7.871536524
1407,3,êmñÿí¨,3498,3800,-302,-7.947368421,167.96,20.8,1480,1493,-13,-0.870730074
1408,3,ó]ésí¨,19631,21258,-1627,-7.653589237,140.59,139.6,8711,9051,-340,-3.756490996
1409,3,ê‘à‰êÏë∫,1122,1262,-140,-11.09350238,280.09,4,534,619,-85,-13.73182553
1420,c,ãÛímëççáêUãªã«,72770,79345,-6575,-8.286596509,2192.42,33.2,29094,30552,-1458,-4.772191673
1423,3,ìÏñyí¨,7930,8778,-848,-9.660514924,81.36,97.5,2968,3068,-100,-3.259452412
1424,3,ìﬁà‰ç]í¨,5678,6194,-516,-8.330642557,88.19,64.4,2466,2622,-156,-5.949656751
1425,3,è„çªêÏí¨,3490,4086,-596,-14.58639256,39.98,87.3,1744,1954,-210,-10.74718526
1427,3,óRêmí¨,5316,5896,-580,-9.837177748,133.74,39.7,2140,2258,-118,-5.225863596
1428,3,í∑è¿í¨,11088,11691,-603,-5.157813703,168.52,65.8,4246,4324,-78,-1.803885291
1429,3,åIéRí¨,12354,13340,-986,-7.391304348,203.93,60.6,5187,5484,-297,-5.415754923
1430,3,åéå`í¨,4578,4859,-281,-5.783082939,150.4,30.4,1467,1511,-44,-2.911978822
1431,3,âYâPí¨,1985,2206,-221,-10.01813237,101.83,19.5,877,920,-43,-4.673913044
1432,3,êVè\í√êÏí¨,6840,7249,-409,-5.642157539,495.47,13.8,2579,2694,-115,-4.26874536
1433,3,ñÖîwãçí¨,3083,3462,-379,-10.94742923,48.64,63.4,1287,1356,-69,-5.088495575
1434,3,íÅïÉï í¨,2516,2730,-214,-7.838827839,47.18,53.3,1017,1052,-35,-3.326996198
1436,3,âJó≥í¨,2748,3049,-301,-9.87208921,191.15,14.4,1004,1067,-63,-5.904404874
1437,3,ñkó≥í¨,1981,2193,-212,-9.667122663,158.7,12.5,782,805,-23,-2.857142857
1438,3,è¿ìcí¨,3183,3612,-429,-11.87707641,283.35,11.2,1330,1437,-107,-7.446068198
1450,c,è„êÏëççáêUãªã«,91972,96633,-4661,-4.823404013,7615.91,12.1,38320,38748,-428,-1.104573139
1452,3,ëÈê≤í¨,7016,7345,-329,-4.479237577,139.42,50.3,2713,2732,-19,-0.695461201
1453,3,ìåê_äyí¨,10231,9292,939,10.10546707,68.5,149.4,3656,3290,366,11.12462006
1454,3,ìññÉí¨,6692,7087,-395,-5.573585438,204.9,32.7,2697,2743,-46,-1.67699599
1455,3,î‰ïzí¨,3781,4042,-261,-6.457199406,86.9,43.5,1586,1639,-53,-3.233679073
1456,3,à§ï í¨,2979,3328,-349,-10.48677885,250.13,11.9,1292,1332,-40,-3.003003003
1457,3,è„êÏí¨,4052,4532,-480,-10.5913504,1049.47,3.9,2103,2303,-200,-8.684324794
1458,3,ìåêÏí¨,8115,7859,256,3.257411885,247.3,32.8,3149,2983,166,5.564867583
1459,3,î¸âlí¨,10297,10956,-659,-6.014968967,676.78,15.2,4305,4301,4,0.093001628
1460,3,è„ïxó«ñÏí¨,10814,11545,-731,-6.331745344,237.1,45.6,4363,4416,-53,-1.200181159
1461,3,íÜïxó«ñÏí¨,5071,5477,-406,-7.412817236,108.65,46.7,2020,2015,5,0.248138958
1462,3,ìÏïxó«ñÏí¨,2555,2814,-259,-9.2039801,665.54,3.8,1132,1199,-67,-5.587989992
1463,3,êËä•ë∫,1211,1394,-183,-13.1276901,571.41,2.1,709,794,-85,-10.70528967
1464,3,òaä¶í¨,3599,3832,-233,-6.080375783,225.11,16,1526,1601,-75,-4.684572142
1465,3,åïï£í¨,3235,3565,-330,-9.256661992,130.99,24.7,1332,1329,3,0.225733634
1468,3,â∫êÏí¨,3547,3775,-228,-6.039735099,644.2,5.5,1672,1685,-13,-0.771513353
1469,3,î¸ê[í¨,4659,5178,-519,-10.02317497,672.09,6.9,2041,2194,-153,-6.973564266
1470,3,âπà–éqï{ë∫,832,995,-163,-16.38190955,275.63,3,411,486,-75,-15.43209877
1471,3,íÜêÏí¨,1763,1907,-144,-7.551127425,594.74,3,898,926,-28,-3.023758099
1472,3,ñyâ¡ì‡í¨,1523,1710,-187,-10.93567251,767.04,2,715,780,-65,-8.333333333
1480,c,óØñGêUãªã«,25695,28648,-2953,-10.3078749,3148.05,8.2,11535,12276,-741,-6.036168133
1481,3,ëùñ—í¨,4504,5078,-574,-11.30366286,369.71,12.2,2052,2208,-156,-7.065217391
1482,3,è¨ïΩí¨,3339,3717,-378,-10.16949153,627.22,5.3,1420,1512,-92,-6.084656085
1483,3,ìœëOí¨,3266,3656,-390,-10.66739606,454.6,7.2,1421,1520,-99,-6.513157895
1484,3,âHñyí¨,7321,7964,-643,-8.073832245,472.65,15.5,3367,3534,-167,-4.725523486
1485,3,èâéRï ë∫,1218,1369,-151,-11.02994887,279.51,4.4,545,579,-34,-5.872193437
1486,3,âìï í¨,2807,3084,-277,-8.981841764,590.8,4.8,1220,1304,-84,-6.441717791
1487,3,ìVâñí¨,3240,3780,-540,-14.28571429,353.56,9.2,1510,1619,-109,-6.732550957
1510,c,è@íJëççáêUãªã«,31121,33852,-2731,-8.067470164,3864.6,8.1,14262,15056,-794,-5.273645058
1511,3,âéï•ë∫,2683,2825,-142,-5.026548673,589.97,4.5,1174,1220,-46,-3.770491803
1512,3,ïlì⁄ï í¨,3880,4168,-288,-6.909788868,401.64,9.7,1850,1868,-18,-0.96359743
1513,3,íÜì⁄ï í¨,1752,1974,-222,-11.24620061,398.51,4.4,782,817,-35,-4.283965728
1514,3,é}çKí¨,8440,9125,-685,-7.506849315,1115.93,7.6,3772,3952,-180,-4.55465587
1516,3,ñLïxí¨,4054,4378,-324,-7.400639561,520.69,7.8,1776,1854,-78,-4.207119741
1517,3,óÁï∂í¨,2776,3078,-302,-9.811565952,81.64,34,1339,1445,-106,-7.335640138
1518,3,óòêKí¨,2303,2590,-287,-11.08108108,76.51,30.1,1153,1313,-160,-12.18583397
1519,3,óòêKïxémí¨,2788,3037,-249,-8.198880474,105.61,26.4,1267,1363,-96,-7.043286867
1520,3,ñyâÑí¨,2445,2677,-232,-8.666417632,574.1,4.3,1149,1224,-75,-6.12745098
1540,c,ÉIÉzÅ[ÉcÉNëççáêUãªã«,110114,118572,-8458,-7.133218635,7961.41,13.8,47314,49024,-1710,-3.488087467
1543,3,î¸ñyí¨,20300,21575,-1275,-5.909617613,438.41,46.3,8626,8725,-99,-1.134670487
1544,3,í√ï í¨,5008,5646,-638,-11.30003542,716.8,7,2231,2358,-127,-5.385920271
1545,3,éŒó¢í¨,12226,13045,-819,-6.278267536,737.12,16.6,5560,5759,-199,-3.455461018
1546,3,ê¥ó¢í¨,4226,4551,-325,-7.141287629,402.76,10.5,1671,1784,-113,-6.334080718
1547,3,è¨ê¥êÖí¨,5086,5358,-272,-5.07652109,286.89,17.7,2033,2069,-36,-1.739971001
1549,3,åPéqï{í¨,5101,5435,-334,-6.145354186,190.95,26.7,1910,1956,-46,-2.351738241
1550,3,íuåÀí¨,3092,3428,-336,-9.801633606,527.27,5.9,1304,1367,-63,-4.608632041
1552,3,ç≤òCä‘í¨,5364,5892,-528,-8.961303462,404.94,13.2,2312,2415,-103,-4.265010352
1555,3,âìåyí¨,20864,22265,-1401,-6.292387155,1332.45,15.7,9267,9617,-350,-3.639388583
1559,3,óNï í¨,9236,10041,-805,-8.017129768,505.79,18.3,3861,4010,-149,-3.715710723
1560,3,ëÍè„í¨,2719,3028,-309,-10.20475561,766.89,3.5,1315,1376,-61,-4.433139535
1561,3,ãªïîí¨,3908,4301,-393,-9.137409905,362.54,10.8,1784,1877,-93,-4.954714971
1562,3,êºãªïîë∫,1118,1135,-17,-1.497797357,308.08,3.6,501,516,-15,-2.906976744
1563,3,óYïêí¨,4527,4939,-412,-8.341769589,636.86,7.1,2066,2228,-162,-7.271095153
1564,3,ëÂãÛí¨,7339,7933,-594,-7.487709568,343.66,21.4,2873,2967,-94,-3.16818335
1570,c,í_êUëççáêUãªã«,55837,60630,-4793,-7.905327396,2398.17,23.3,24929,25895,-966,-3.730449894
1571,3,ñLâYí¨,4298,4528,-230,-5.0795053,233.57,18.4,2007,1944,63,3.240740741
1575,3,ësïÀí¨,2925,3232,-307,-9.498762376,205.01,14.3,1172,1226,-54,-4.4045677
1578,3,îíòVí¨,17744,19376,-1632,-8.422791082,425.64,41.7,7956,8412,-456,-5.420827389
1581,3,å˙ê^í¨,4825,4890,-65,-1.329243354,404.61,11.9,2116,1972,144,7.302231237
1584,3,ì¥ñÍåŒí¨,9308,10132,-824,-8.132649033,180.81,51.5,4237,4461,-224,-5.021295674
1585,3,à¿ïΩí¨,8144,8726,-582,-6.669722668,237.16,34.3,3655,3753,-98,-2.611244338
1586,3,ÇﬁÇ©ÇÌí¨,8593,9746,-1153,-11.83049456,711.36,12.1,3786,4127,-341,-8.262660528
1600,c,ì˙çÇêUãªã«,69038,75321,-6283,-8.341631152,4811.13,14.3,31126,32479,-1353,-4.165768651
1601,3,ì˙çÇí¨,12377,13615,-1238,-9.092912229,992.11,12.5,5784,6064,-280,-4.617414248
1602,3,ïΩéÊí¨,5310,5596,-286,-5.110793424,743.09,7.1,2369,2412,-43,-1.782752902
1604,3,êVä•í¨,5596,5775,-179,-3.0995671,585.81,9.6,2404,2388,16,0.67001675
1607,3,âYâÕí¨,13081,14389,-1308,-9.090277295,694.26,18.8,6151,6358,-207,-3.255740799
1608,3,óléóí¨,4519,5114,-595,-11.6347282,364.3,12.4,2046,2206,-160,-7.25294651
1609,3,Ç¶ÇËÇ‡í¨,4905,5413,-508,-9.384814336,284,17.3,1932,2036,-104,-5.10805501
1610,3,êVÇ–ÇæÇ©í¨,23250,25419,-2169,-8.532987136,1147.55,20.3,10440,11015,-575,-5.220154335
1630,c,è\èüëççáêUãªã«,174132,180540,-6408,-3.549351944,10212.28,17.1,72807,72681,126,0.173360301
1631,3,âπçXí¨,44835,45085,-250,-0.554508151,466.02,96.2,18020,17660,360,2.038505096
1632,3,émñyí¨,6135,6416,-281,-4.379675811,259.19,23.7,2479,2458,21,0.854353133
1633,3,è„émñyí¨,4775,5080,-305,-6.003937008,694.23,6.9,2178,2225,-47,-2.112359551
1634,3,é≠í«í¨,5542,5702,-160,-2.806032971,402.88,13.8,2251,2270,-19,-0.837004405
1635,3,êVìæí¨,6290,6653,-363,-5.45618518,1063.83,5.9,3026,3106,-80,-2.575660013
1636,3,ê¥êÖí¨,9605,9961,-356,-3.57393836,402.25,23.9,4118,4097,21,0.512570173
1637,3,âËé∫í¨,18478,18905,-427,-2.25866173,513.76,36,7173,7089,84,1.184934405
1638,3,íÜéDì‡ë∫,3969,4006,-37,-0.923614578,292.58,13.6,1609,1570,39,2.484076433
1639,3,çXï ë∫,3186,3391,-205,-6.045414332,176.9,18,1239,1274,-35,-2.747252747
1641,3,ëÂé˜í¨,5734,5977,-243,-4.065584742,815.68,7,2536,2533,3,0.118436636
1642,3,çLîˆí¨,7032,7881,-849,-10.77274458,596.54,11.8,3162,3294,-132,-4.007285975
1643,3,ñãï í¨,26764,26547,217,0.817418164,477.64,56,10936,10359,577,5.570035718
1644,3,írìcí¨,6886,7527,-641,-8.516009034,371.79,18.5,3048,3189,-141,-4.42144873
1645,3,ñLç†í¨,3183,3394,-211,-6.216853271,536.71,5.9,1362,1376,-14,-1.017441861
1646,3,ñ{ï í¨,7343,8275,-932,-11.26283988,391.91,18.7,3258,3482,-224,-6.433084434
1647,3,ë´äÒí¨,6989,7630,-641,-8.401048493,1408.04,5,3179,3348,-169,-5.047789725
1648,3,ó§ï í¨,2475,2650,-175,-6.603773585,608.9,4.1,1147,1135,12,1.057268723
1649,3,âYñyí¨,4911,5460,-549,-10.05494505,729.85,6.7,2086,2216,-130,-5.866425993
1660,c,ã˙òHëççáêUãªã«,61792,66151,-4359,-6.589469547,4634.58,13.3,25990,26592,-602,-2.263838749
1661,3,ã˙òHí¨,19833,20526,-693,-3.376205788,252.66,78.5,8116,8098,18,0.222277106
1662,3,å˙ä›í¨,9777,10630,-853,-8.024459078,739.26,13.2,4115,4278,-163,-3.810191678
1663,3,ïlíÜí¨,6064,6511,-447,-6.865304869,423.63,14.3,2326,2344,-18,-0.767918089
1664,3,ïWíÉí¨,7740,8285,-545,-6.578153289,1099.37,7,3281,3365,-84,-2.49628529
1665,3,íÌéqã¸í¨,7771,8278,-507,-6.124667794,774.33,10,3507,3632,-125,-3.441629956
1667,3,íﬂãèë∫,2536,2627,-91,-3.464027408,571.8,4.4,1035,979,56,5.720122574
1668,3,îíçfí¨,8071,9294,-1223,-13.15902733,773.53,10.4,3610,3896,-286,-7.340862423
1690,c,ç™é∫êUãªã«,49721,51368,-1647,-3.206276281,7994.12,16.1,20696,20358,338,1.660280971
1691,3,ï äCí¨,15286,15855,-569,-3.588773258,1319.63,11.6,5993,5862,131,2.234732173
1692,3,íÜïWí√í¨,23777,23982,-205,-0.854807773,684.87,34.7,10433,10084,349,3.460928203
1693,3,ïWí√í¨,5243,5646,-403,-7.13779667,624.68,8.4,2169,2235,-66,-2.953020134
1694,3,óÖâPí¨,5415,5885,-470,-7.986406117,397.72,13.6,2101,2177,-76,-3.491042719
2000,a,ê¬êXåß,1308649,1373339,-64690,-4.710417457,9645.4,135.7,510948,513385,-2437,-0.474692482
2001,b,ésïî,1013653,1054602,-40949,-3.882886625,4584.81,221.1,403524,402619,905,0.224778264
2002,b,åSïî,294996,318737,-23741,-7.448460643,5060.59,58.3,107424,110766,-3342,-3.017171334
2201,2,ê¬êXés,287622,299520,-11898,-3.972355769,824.61,348.8,118279,119413,-1134,-0.949645349
2202,2,çOëOés,177549,183473,-5924,-3.228812959,524.2,338.7,71171,70142,1029,1.467024037
2203,2,î™åÀés,231379,237615,-6236,-2.624413442,305.54,757.3,93726,91917,1809,1.968079898
2204,2,çïêŒés,34293,36132,-1839,-5.089671206,217.05,158,11771,11794,-23,-0.195014414
2205,2,å‹èäêÏå¥és,55171,58421,-3250,-5.563068075,404.18,136.5,21136,21277,-141,-0.662687409
2206,2,è\òaìcés,63454,66110,-2656,-4.017546513,725.65,87.4,25509,25554,-45,-0.176097676
2207,2,éOëÚés,40223,41258,-1035,-2.508604392,119.87,335.6,16377,16211,166,1.023996052
2208,2,ÇﬁÇ¬és,58506,61066,-2560,-4.192185504,864.16,67.7,24446,24775,-329,-1.327951564
2209,2,Ç¬Ç™ÇÈés,33326,37243,-3917,-10.51741267,253.55,131.4,10979,11473,-494,-4.305761353
2210,2,ïΩêÏés,32130,33764,-1634,-4.839473996,346.01,92.9,10130,10063,67,0.665805426
2300,c,ìåí√åyåS,22988,25938,-2950,-11.37327473,653.29,35.2,8787,9436,-649,-6.877914371
2301,3,ïΩì‡í¨,11148,12361,-1213,-9.813121916,217.09,51.4,3968,4198,-230,-5.478799428
2303,3,ç°ï í¨,2747,3217,-470,-14.60988499,125.27,21.9,1289,1379,-90,-6.526468455
2304,3,ñHìcë∫,2896,3271,-375,-11.46438398,80.65,35.9,957,1070,-113,-10.56074766
2307,3,äOÉñïlí¨,6197,7089,-892,-12.58287488,230.29,26.9,2573,2789,-216,-7.744711366
2320,c,êºí√åyåS,18554,21140,-2586,-12.23273415,831.96,22.3,7155,7627,-472,-6.188540711
2321,3,ÈÀÉñëÚí¨,10131,11449,-1318,-11.51192244,343.08,29.5,3851,4095,-244,-5.958485959
2323,3,ê[âYí¨,8423,9691,-1268,-13.08430503,488.89,17.2,3304,3532,-228,-6.455266138
2340,c,íÜí√åyåS,1415,1594,-179,-11.22961104,246.02,5.8,488,570,-82,-14.38596491
2343,3,êºñ⁄âÆë∫,1415,1594,-179,-11.22961104,246.02,5.8,488,570,-82,-14.38596491
2360,c,ìÏí√åyåS,32647,35152,-2505,-7.126194811,223.06,146.4,10742,10966,-224,-2.042677366
2361,3,ì°çËí¨,15180,16021,-841,-5.249360215,37.29,407.1,4941,4912,29,0.59039088
2362,3,ëÂòkí¨,9684,10978,-1294,-11.78721079,163.43,59.3,3419,3648,-229,-6.277412281
2367,3,ìcé…äŸë∫,7783,8153,-370,-4.538206795,22.35,348.2,2382,2406,-24,-0.997506234
2380,c,ñkí√åyåS,38542,42240,-3698,-8.754734849,304.64,126.5,13175,13542,-367,-2.710087136
2381,3,î¬ñˆí¨,13937,15227,-1290,-8.471793525,41.88,332.8,4680,4770,-90,-1.886792453
2384,3,íﬂìcí¨,13400,14270,-870,-6.096706377,46.43,288.6,4384,4402,-18,-0.408905043
2387,3,íÜîëí¨,11205,12743,-1538,-12.06937142,216.32,51.8,4111,4370,-259,-5.926773455
2400,c,è„ñkåS,96924,100607,-3683,-3.660779071,1280.32,75.7,35781,35758,23,0.064321271
2401,3,ñÏï”íní¨,13520,14314,-794,-5.547016907,81.68,165.5,5542,5766,-224,-3.884842178
2402,3,éµåÀí¨,15719,16759,-1040,-6.20562086,337.23,46.6,5585,5713,-128,-2.240504113
2405,3,òZåÀí¨,10423,10241,182,1.777170198,83.89,124.2,3570,3307,263,7.952827336
2406,3,â°ïlí¨,4535,4881,-346,-7.08871133,126.38,35.9,1786,1884,-98,-5.201698514
2408,3,ìåñkí¨,17969,19106,-1137,-5.951010154,326.5,55,5980,6007,-27,-0.449475612
2411,3,òZÉñèäë∫,10538,11095,-557,-5.020279405,252.68,41.7,4683,4751,-68,-1.431277626
2412,3,Ç®Ç¢ÇÁÇπí¨,24220,24211,9,0.037173186,71.96,336.6,8635,8330,305,3.661464586
2420,c,â∫ñkåS,15953,18477,-2524,-13.66022623,551.96,28.9,6474,7430,-956,-12.86675639
2423,3,ëÂä‘í¨,5220,6340,-1120,-17.66561514,52.1,100.2,2161,2636,-475,-18.01972686
2424,3,ìåí ë∫,6604,7252,-648,-8.935466078,295.27,22.4,2578,2710,-132,-4.870848709
2425,3,ïóä‘âYë∫,1977,2463,-486,-19.7320341,69.55,28.4,822,1096,-274,-25
2426,3,ç≤à‰ë∫,2152,2422,-270,-11.14781173,135.04,15.9,913,988,-75,-7.591093117
2440,c,éOåÀåS,67973,73589,-5616,-7.631575371,969.33,70.1,24822,25437,-615,-2.417737941
2441,3,éOåÀí¨,10150,11299,-1149,-10.16904151,151.79,66.9,3758,3961,-203,-5.124968442
2442,3,å‹åÀí¨,17433,18712,-1279,-6.835185977,177.67,98.1,6126,6177,-51,-0.825643516
2443,3,ìcéqí¨,5553,6175,-622,-10.07287449,241.98,22.9,2005,2097,-92,-4.387219838
2445,3,ìÏïîí¨,18319,19853,-1534,-7.726791921,153.12,119.6,6420,6621,-201,-3.035795197
2446,3,äKè„í¨,14008,14699,-691,-4.701000068,94.01,149,5682,5707,-25,-0.438058525
2450,3,êVãΩë∫,2510,2851,-341,-11.96071554,150.77,16.6,831,874,-43,-4.919908467
3000,a,ä‚éËåß,1279814,1330147,-50333,-3.784017857,15275.01,83.8,491725,483934,7791,1.60993028
3001,b,ésïî,1054537,1086795,-32258,-2.968177071,9650.72,109.3,410777,401977,8800,2.189179978
3002,b,åSïî,225277,243352,-18075,-7.42751241,5624.29,40.1,80948,81957,-1009,-1.231133399
3201,2,ê∑â™és,297669,298348,-679,-0.227586577,886.47,335.8,128848,125096,3752,2.99929654
3202,2,ã{å√és,56569,59430,-2861,-4.81406697,1259.15,44.9,23365,22509,856,3.802923275
3203,2,ëÂëDìnés,38068,40737,-2669,-6.551783391,322.5,118,14811,14819,-8,-0.053984749
3205,2,â‘ä™és,97771,101438,-3667,-3.615016069,908.39,107.6,33833,33774,59,0.17469059
3206,2,ñkè„és,93591,93138,453,0.486375056,437.55,213.9,35812,34068,1744,5.119173418
3207,2,ãvéúés,35644,36872,-1228,-3.330440443,623.5,57.2,14182,14012,170,1.213245789
3208,2,âìñÏés,28071,29331,-1260,-4.295796257,825.97,34,9961,9888,73,0.738268608
3209,2,àÍä÷és,121625,127642,-6017,-4.713965623,1256.42,96.8,43015,42633,382,0.896019515
3210,2,ó§ëOçÇìcés,19757,23300,-3543,-15.20600858,231.94,85.2,7487,7785,-298,-3.827874117
3211,2,äòêŒés,36812,39574,-2762,-6.979329863,440.34,83.6,16854,16094,760,4.722256742
3213,2,ìÒåÀés,27637,29702,-2065,-6.952393778,420.42,65.7,10672,10847,-175,-1.613349313
3214,2,î™î¶ïΩés,26371,28680,-2309,-8.050906555,862.3,30.6,9434,9664,-230,-2.379966887
3215,2,âúèBés,119465,124746,-5281,-4.233402273,993.3,120.3,41725,41388,337,0.814245675
3216,2,ëÍëÚés,55487,53857,1630,3.026533227,182.46,304.1,20778,19400,1378,7.103092784
3300,c,ä‚éËåS,37006,40321,-3315,-8.221522284,1404.24,26.4,12870,13246,-376,-2.838592783
3301,3,é¥êŒí¨,16967,18033,-1066,-5.911384684,608.82,27.9,5486,5543,-57,-1.028324012
3302,3,äãä™í¨,6340,7304,-964,-13.19824754,434.96,14.6,2461,2664,-203,-7.62012012
3303,3,ä‚éËí¨,13699,14984,-1285,-8.575814202,360.46,38,4923,5039,-116,-2.302044056
3320,c,éáîgåS,60309,60493,-184,-0.304167424,306.3,196.9,20642,19369,1273,6.572357892
3321,3,éáîgí¨,32626,33288,-662,-1.988704638,238.98,136.5,10808,10513,295,2.806049653
3322,3,ñÓã–í¨,27683,27205,478,1.757029958,67.32,411.2,9834,8856,978,11.04336043
3360,c,òaâÍåS,5880,6602,-722,-10.93607998,590.74,10,2146,2272,-126,-5.545774648
3366,3,êºòaâÍí¨,5880,6602,-722,-10.93607998,590.74,10,2146,2272,-126,-5.545774648
3380,c,í_ëÚåS,15909,16325,-416,-2.548238897,179.76,88.5,5624,5409,215,3.97485672
3381,3,ã‡ÉPçËí¨,15909,16325,-416,-2.548238897,179.76,88.5,5624,5409,215,3.97485672
3400,c,êºî÷à‰åS,7869,8345,-476,-5.70401438,63.39,124.1,2478,2454,24,0.97799511
3402,3,ïΩêÚí¨,7869,8345,-476,-5.70401438,63.39,124.1,2478,2454,24,0.97799511
3440,c,ãCêÂåS,5723,6190,-467,-7.544426494,334.84,17.1,2119,2083,36,1.728276524
3441,3,èZìcí¨,5723,6190,-467,-7.544426494,334.84,17.1,2119,2083,36,1.728276524
3460,c,è„ï¬à…åS,11732,15276,-3544,-23.19979052,200.42,58.5,4571,5689,-1118,-19.65195992
3461,3,ëÂí∆í¨,11732,15276,-3544,-23.19979052,200.42,58.5,4571,5689,-1118,-19.65195992
3480,c,â∫ï¬à…åS,31922,36352,-4430,-12.18639965,1481.02,21.6,12828,13313,-485,-3.64305566
3482,3,éRìcí¨,15826,18617,-2791,-14.99167428,262.81,60.2,6265,6605,-340,-5.147615443
3483,3,ä‚êÚí¨,9839,10804,-965,-8.931877083,992.36,9.9,4174,4357,-183,-4.200137709
3484,3,ìcñÏî®ë∫,3461,3843,-382,-9.940150924,156.19,22.2,1291,1309,-18,-1.375095493
3485,3,ïÅë„ë∫,2796,3088,-292,-9.455958549,69.66,40.1,1098,1042,56,5.37428023
3500,c,ã„åÀåS,36015,39261,-3246,-8.267746619,763.55,47.2,12781,13075,-294,-2.248565966
3501,3,åyïƒí¨,9333,10209,-876,-8.58066412,245.82,38,3318,3343,-25,-0.747831289
3503,3,ñÏìcë∫,4127,4632,-505,-10.90241796,80.8,51.1,1529,1578,-49,-3.105196451
3506,3,ã„åÀë∫,5861,6507,-646,-9.927770094,134.02,43.7,1986,2034,-48,-2.359882006
3507,3,ómñÏí¨,16694,17913,-1219,-6.805113605,302.92,55.1,5948,6120,-172,-2.810457516
3520,c,ìÒåÀåS,12912,14187,-1275,-8.987100867,300.03,43,4889,5047,-158,-3.130572617
3524,3,àÍåÀí¨,12912,14187,-1275,-8.987100867,300.03,43,4889,5047,-158,-3.130572617
4000,a,ã{èÈåß,2334215,2348165,-13950,-0.59408091,7282.14,320.5,944719,901862,42857,4.75205741
4001,b,ésïî,1922394,1922881,-487,-0.02532658,4542.18,423.2,803253,764888,38365,5.015767014
4002,b,åSïî,411821,425284,-13463,-3.165649307,2739.95,150.3,141466,136974,4492,3.279454495
4100,1,êÂë‰és,1082185,1045986,36199,3.460753777,786.3,1376.3,499090,465260,33830,7.271203198
4101,0,êÂë‰és ê¬ótãÊ,310181,291436,18745,6.431943892,302.24,1026.3,158458,144125,14333,9.944839549
4102,0,êÂë‰és ã{èÈñÏãÊ,194930,190473,4457,2.339964194,58.19,3349.9,90082,85925,4157,4.837940064
4103,0,êÂë‰és é·ó—ãÊ,133419,132306,1113,0.84123169,50.86,2623.3,61885,58914,2971,5.042943952
4104,0,êÂë‰és ëæîíãÊ,226687,220588,6099,2.764882949,228.39,992.5,98539,91526,7013,7.662303608
4105,0,êÂë‰és êÚãÊ,216968,211183,5785,2.739330344,146.61,1479.9,90126,84770,5356,6.318272974
4202,2,êŒä™és,147236,160826,-13590,-8.450126223,554.5,265.5,56739,57871,-1132,-1.956074718
4203,2,âñ‚}és,54195,56490,-2295,-4.062665959,17.37,3120,20547,20396,151,0.740341243
4205,2,ãCêÂè¿és,64917,73489,-8572,-11.66433072,332.44,195.3,24139,25457,-1318,-5.177357898
4206,2,îíêŒés,35274,37422,-2148,-5.739939073,286.48,123.1,12560,12532,28,0.223428024
4207,2,ñºéÊés,76719,73134,3585,4.901960784,98.17,781.5,27517,25124,2393,9.524757204
4208,2,äpìcés,30193,31336,-1143,-3.64756191,147.53,204.7,10398,10082,316,3.13429875
4209,2,ëΩâÍèÈés,62128,63060,-932,-1.477957501,19.69,3155.3,24074,24079,-5,-0.020764982
4211,2,ä‚è¿és,44704,44187,517,1.170027384,60.45,739.5,16593,15519,1074,6.920549004
4212,2,ìoïƒés,81989,83969,-1980,-2.358013076,536.12,152.9,26234,25002,1232,4.927605792
4213,2,åIå¥és,69906,74932,-5026,-6.707414723,804.97,86.8,23192,23407,-215,-0.918528645
4214,2,ìåèºìáés,39518,42903,-3385,-7.88989115,101.36,389.9,13854,14013,-159,-1.134660672
4215,2,ëÂçËés,133430,135147,-1717,-1.270468453,796.8,167.5,48316,46146,2170,4.702466086
4300,c,ä†ìcåS,13782,14576,-794,-5.447310648,415.92,33.1,4480,4512,-32,-0.709219858
4301,3,ë†â§í¨,12324,12882,-558,-4.331625524,152.83,80.6,3913,3890,23,0.59125964
4302,3,éµÉñèhí¨,1458,1694,-236,-13.93152302,263.09,5.5,567,622,-55,-8.84244373
4320,c,éƒìcåS,84005,84844,-839,-0.988873698,428.17,196.2,30853,29648,1205,4.0643551
4321,3,ëÂâÕå¥í¨,23800,23530,270,1.147471313,24.99,952.4,9101,8641,460,5.323457933
4322,3,ë∫ìcí¨,11505,11995,-490,-4.085035431,78.38,146.8,3761,3630,131,3.608815427
4323,3,éƒìcí¨,39533,39341,192,0.488040467,54.03,731.7,15113,14490,623,4.299516908
4324,3,êÏçËí¨,9167,9978,-811,-8.127881339,270.77,33.9,2878,2887,-9,-0.311742293
4340,c,à…ãÔåS,13984,15501,-1517,-9.786465389,273.3,51.2,4551,4649,-98,-2.107980211
4341,3,ä€êXí¨,13984,15501,-1517,-9.786465389,273.3,51.2,4551,4649,-98,-2.107980211
4360,c,òjóùåS,45912,51549,-5637,-10.93522668,138.18,332.3,15746,16138,-392,-2.429049449
4361,3,òjóùí¨,33598,34845,-1247,-3.578705697,73.6,456.5,11321,10903,418,3.833807209
4362,3,éRå≥í¨,12314,16704,-4390,-26.28113027,64.58,190.7,4425,5235,-810,-15.47277937
4400,c,ã{èÈåS,68956,69495,-539,-0.775595367,111.64,617.7,23456,22370,1086,4.854716138
4401,3,èºìáí¨,14424,15085,-661,-4.381836261,53.56,269.3,5105,5137,-32,-0.622931672
4404,3,éµÉñïlí¨,18651,20416,-1765,-8.645180251,13.19,1414,6167,6415,-248,-3.865939205
4406,3,óòï{í¨,35881,33994,1887,5.550979585,44.89,799.3,12184,10818,1366,12.62710298
4420,c,çïêÏåS,93920,86197,7723,8.959708575,417,225.2,31857,27368,4489,16.40236773
4421,3,ëÂòaí¨,28252,24894,3358,13.48919418,225.49,125.3,10170,8056,2114,26.24131082
4422,3,ëÂãΩí¨,8371,8927,-556,-6.22829618,82.01,102.1,2421,2423,-2,-0.082542303
4423,3,ïxíJí¨,51592,47042,4550,9.672207814,49.18,1049,17488,15399,2089,13.56581596
4424,3,ëÂçtë∫,5705,5334,371,6.955380577,60.32,94.6,1778,1490,288,19.32885906
4440,c,â¡î¸åS,30981,32958,-1977,-5.998543601,569.94,54.4,9534,9520,14,0.147058824
4444,3,êFñÉí¨,7240,7431,-191,-2.570313551,109.28,66.3,1973,1923,50,2.600104004
4445,3,â¡î¸í¨,23741,25527,-1786,-6.996513496,460.67,51.5,7561,7597,-36,-0.473871265
4500,c,âììcåS,41572,42684,-1112,-2.605191641,157.06,264.7,13798,13506,292,2.162002073
4501,3,óOíJí¨,16707,17494,-787,-4.498685264,82.16,203.3,5474,5496,-22,-0.400291121
4505,3,î¸ó¢í¨,24865,25190,-325,-1.290194522,74.9,332,8324,8010,314,3.920099875
4580,c,â≤é≠åS,6334,10051,-3717,-36.98139489,65.35,96.9,3154,3968,-814,-20.5141129
4581,3,èóêÏí¨,6334,10051,-3717,-36.98139489,65.35,96.9,3154,3968,-814,-20.5141129
4600,c,ñ{ãgåS,12375,17429,-5054,-28.9976476,163.4,75.7,4037,5295,-1258,-23.75826251
4606,3,ìÏéOó§í¨,12375,17429,-5054,-28.9976476,163.4,75.7,4037,5295,-1258,-23.75826251
5000,a,èHìcåß,1022839,1085997,-63158,-5.815669841,11637.54,87.9,388621,390136,-1515,-0.388326122
5001,b,ésïî,925513,979084,-53571,-5.471542789,9340.13,99.1,355687,355676,11,0.003092702
5002,b,åSïî,97326,106913,-9587,-8.967104094,2275.44,42.8,32934,34460,-1526,-4.428322693
5201,2,èHìcés,315374,323600,-8226,-2.542027194,906.09,348.1,135369,131318,4051,3.08487793
5202,2,î\ë„és,54746,59084,-4338,-7.342089229,426.95,128.2,22373,22806,-433,-1.898623169
5203,2,â°éËés,92214,98367,-6153,-6.255146543,692.8,133.1,31493,31807,-314,-0.987204075
5204,2,ëÂäŸés,74153,78946,-4793,-6.071238568,913.22,81.2,28260,28565,-305,-1.067740242
5206,2,íjé≠és,28395,32294,-3899,-12.07345018,241.09,117.8,11143,11625,-482,-4.146236559
5207,2,ìíëÚés,46620,50849,-4229,-8.316781058,790.91,58.9,16363,16855,-492,-2.919015129
5209,2,é≠äpés,32057,34473,-2416,-7.008383373,707.52,45.3,11509,11863,-354,-2.984068111
5210,2,óRóòñ{ëëés,79993,85229,-5236,-6.143448826,1209.6,66.1,28347,28648,-301,-1.050684166
5211,2,äÉè„és,33098,34442,-1344,-3.902212415,97.73,338.7,12023,11936,87,0.7288874
5212,2,ëÂêÂés,82773,88301,-5528,-6.260404752,866.77,95.5,28195,28354,-159,-0.56076744
5213,2,ñkèHìcés,33230,36387,-3157,-8.676175557,1152.76,28.8,12223,12837,-614,-4.783048999
5214,2,Ç…Ç©ÇŸés,25330,27544,-2214,-8.038048214,241.13,105,8804,9203,-399,-4.335542758
5215,2,êÂñkés,27530,29568,-2038,-6.89258658,1093.56,25.2,9585,9859,-274,-2.77918653
5300,c,é≠äpåS,5342,6054,-712,-11.76081929,201.7,26.5,2168,2390,-222,-9.288702929
5303,3,è¨ç‚í¨,5342,6054,-712,-11.76081929,201.7,26.5,2168,2390,-222,-9.288702929
5320,c,ñkèHìcåS,2375,2727,-352,-12.90795746,256.72,9.3,919,1008,-89,-8.829365079
5327,3,è„è¨à¢êmë∫,2375,2727,-352,-12.90795746,256.72,9.3,919,1008,-89,-8.829365079
5340,c,éRñ{åS,27742,30944,-3202,-10.34772492,764.26,36.3,9929,10486,-557,-5.311844364
5346,3,ì°ó¢í¨,3360,3848,-488,-12.68191268,282.13,11.9,1215,1322,-107,-8.093797277
5348,3,éOéÌí¨,17077,18876,-1799,-9.530620894,247.98,68.9,6008,6294,-286,-4.544010168
5349,3,î™ïÙí¨,7305,8220,-915,-11.13138686,234.14,31.2,2706,2870,-164,-5.714285714
5360,c,ìÏèHìcåS,23655,25850,-2195,-8.491295938,449.97,52.6,8150,8444,-294,-3.481762198
5361,3,å‹èÈñ⁄í¨,9481,10516,-1035,-9.842145302,214.92,44.1,3574,3733,-159,-4.259308867
5363,3,î™òYäÉí¨,6079,6623,-544,-8.213800393,17,357.6,2216,2303,-87,-3.777681285
5366,3,à‰êÏí¨,4987,5493,-506,-9.211724012,47.95,104,1563,1604,-41,-2.556109726
5368,3,ëÂäÉë∫,3108,3218,-110,-3.418272219,170.11,18.3,797,804,-7,-0.870646766
5420,c,êÂñkåS,20280,21674,-1394,-6.431669281,168.34,120.5,6152,6291,-139,-2.209505643
5434,3,î¸ãΩí¨,20280,21674,-1394,-6.431669281,168.34,120.5,6152,6291,-139,-2.209505643
5460,c,óYèüåS,17932,19664,-1732,-8.807973963,434.46,41.3,5616,5841,-225,-3.852080123
5463,3,âHå„í¨,15321,16792,-1471,-8.760123869,230.78,66.4,4807,4966,-159,-3.20177205
5464,3,ìåê¨ê£ë∫,2611,2872,-261,-9.087743733,203.69,12.8,809,875,-66,-7.542857143
6000,a,éRå`åß,1122957,1168924,-45967,-3.932419901,9323.15,120.4,393920,388608,5312,1.366930171
6001,b,ésïî,895873,924003,-28130,-3.04436241,4711.78,190.1,324640,318315,6325,1.987025431
6002,b,åSïî,227084,244921,-17837,-7.282756481,4611.38,49.2,69280,70293,-1013,-1.441110779
6201,2,éRå`és,252453,254244,-1791,-0.704441403,381.3,662.1,100669,96560,4109,4.255385253
6202,2,ïƒëÚés,86010,89401,-3391,-3.793022449,548.51,156.8,32991,33013,-22,-0.066640414
6203,2,íﬂâ™és,129630,136623,-6993,-5.11846468,1311.53,98.8,45332,45514,-182,-0.399876961
6204,2,éìcés,106267,111151,-4884,-4.394022546,602.97,176.2,39308,38955,353,0.90617379
6205,2,êVèØés,36904,38850,-1946,-5.009009009,222.85,165.6,12976,12980,-4,-0.030816641
6206,2,ä¶âÕç]és,41266,42373,-1107,-2.612512685,139.03,296.8,13073,12717,356,2.799402375
6207,2,è„éRés,31584,33836,-2252,-6.655633054,240.93,131.1,10724,10751,-27,-0.251139429
6208,2,ë∫éRés,24696,26811,-2115,-7.888553206,196.98,125.4,7712,7865,-153,-1.9453274
6209,2,í∑à‰és,27716,29473,-1757,-5.961388389,214.67,129.1,9114,9269,-155,-1.672240803
6210,2,ìVì∂és,62236,62214,22,0.035361816,113.01,550.7,21448,20404,1044,5.116643795
6211,2,ìåç™és,47865,46414,1451,3.126211919,206.94,231.3,15487,14388,1099,7.638309703
6212,2,îˆâ‘ëÚés,16962,18955,-1993,-10.51437615,372.53,45.5,5109,5332,-223,-4.182295574
6213,2,ìÏózés,32284,33658,-1374,-4.082238992,160.52,201.1,10697,10567,130,1.230245103
6300,c,ìåë∫éRåS,25738,27154,-1416,-5.214701333,92.6,277.9,7904,7842,62,0.790614639
6301,3,éRï”í¨,14372,15139,-767,-5.066384834,61.45,233.9,4438,4419,19,0.42996153
6302,3,íÜéRí¨,11366,12015,-649,-5.401581357,31.15,364.9,3466,3423,43,1.256208005
6320,c,êºë∫éRåS,40286,43312,-3026,-6.986516439,796.53,50.6,12521,12595,-74,-0.587534736
6321,3,âÕñkí¨,19046,19959,-913,-4.574377474,52.45,363.1,5868,5740,128,2.229965157
6322,3,êºêÏí¨,5640,6270,-630,-10.04784689,393.19,14.3,1779,1853,-74,-3.993524015
6323,3,í©ì˙í¨,7122,7856,-734,-9.343177189,196.81,36.2,2243,2311,-68,-2.942449156
6324,3,ëÂç]í¨,8478,9227,-749,-8.117481305,154.08,55,2631,2691,-60,-2.229654404
6340,c,ñkë∫éRåS,7359,8160,-801,-9.816176471,79.54,92.5,2143,2227,-84,-3.771890436
6341,3,ëÂêŒìcí¨,7359,8160,-801,-9.816176471,79.54,92.5,2143,2227,-84,-3.771890436
6360,c,ç≈è„åS,41005,45469,-4464,-9.817677978,1580.38,25.9,12109,12546,-437,-3.483181891
6361,3,ã‡éRí¨,5829,6365,-536,-8.421052632,161.67,36.1,1643,1703,-60,-3.523194363
6362,3,ç≈è„í¨,8908,9847,-939,-9.535899259,330.37,27,2674,2764,-90,-3.256150507
6363,3,èMå`í¨,5631,6164,-533,-8.646982479,119.04,47.3,1620,1652,-32,-1.937046005
6364,3,ê^é∫êÏí¨,8136,9165,-1029,-11.22749591,374.22,21.7,2520,2631,-111,-4.218928164
6365,3,ëÂë†ë∫,3413,3762,-349,-9.27698033,211.63,16.1,1017,1045,-28,-2.679425837
6366,3,ç¯êÏë∫,4315,4862,-547,-11.25051419,122.14,35.3,1246,1300,-54,-4.153846154
6367,3,åÀëÚë∫,4773,5304,-531,-10.01131222,261.31,18.3,1389,1451,-62,-4.272915231
6380,c,ìåíuéíåS,39643,42338,-2695,-6.36544003,346.86,114.3,11765,11951,-186,-1.556355117
6381,3,çÇî©í¨,23887,25025,-1138,-4.547452548,180.26,132.5,7215,7241,-26,-0.359066427
6382,3,êÏêºí¨,15756,17313,-1557,-8.993242072,166.6,94.6,4550,4710,-160,-3.397027601
6400,c,êºíuéíåS,29444,32119,-2675,-8.328403749,1224.68,24,9471,9736,-265,-2.721857026
6401,3,è¨çëí¨,7869,8862,-993,-11.20514557,737.56,10.7,2841,3036,-195,-6.422924901
6402,3,îíëÈí¨,14271,15314,-1043,-6.810761395,157.71,90.5,4433,4465,-32,-0.71668533
6403,3,î—ñLí¨,7304,7943,-639,-8.044819338,329.41,22.2,2197,2235,-38,-1.700223714
6420,c,ìåìcêÏåS,29397,30889,-1492,-4.830198453,282.39,104.1,8857,8788,69,0.785161584
6426,3,éOêÏí¨,7728,7731,-3,-0.038804812,33.22,232.6,2219,2140,79,3.691588785
6428,3,èØì‡í¨,21669,23158,-1489,-6.429743501,249.17,87,6638,6648,-10,-0.150421179
6460,c,ñOäCåS,14212,15480,-1268,-8.19121447,208.39,68.2,4510,4608,-98,-2.126736111
6461,3,óVç≤í¨,14212,15480,-1268,-8.19121447,208.39,68.2,4510,4608,-98,-2.126736111
7000,a,ïüìáåß,1913606,2029064,-115458,-5.69020987,13783.75,138.8,736616,720794,15822,2.195079315
7001,b,ésïî,1578540,1602602,-24062,-1.501433294,6031.55,261.7,621590,584500,37090,6.345594525
7002,b,åSïî,335066,426462,-91396,-21.43121779,7752.2,43.2,115026,136294,-21268,-15.60450203
7201,2,ïüìáés,294378,292590,1788,0.611094022,767.72,383.4,122229,113074,9155,8.0964678
7202,2,âÔí√é·èºés,124085,126220,-2135,-1.691491047,382.97,324,49305,47891,1414,2.952538055
7203,2,åSéRés,335608,338712,-3104,-0.916412764,757.2,443.2,138124,131740,6384,4.845908608
7204,2,Ç¢ÇÌÇ´és,349344,342249,7095,2.073052076,1232.02,283.6,140837,128722,12115,9.411755566
7205,2,îíâÕés,61914,64704,-2790,-4.31194362,305.32,202.8,23012,22726,286,1.258470474
7207,2,ê{âÍêÏés,77458,79267,-1809,-2.282160294,279.43,277.2,26343,25792,551,2.13632134
7208,2,äÏëΩï˚és,49421,52356,-2935,-5.605852242,554.63,89.1,16755,16983,-228,-1.34251899
7209,2,ëäînés,38575,37817,758,2.00438956,197.8,195,14891,13227,1664,12.58032812
7210,2,ìÒñ{èºés,58164,59871,-1707,-2.851129929,344.42,168.9,19778,18364,1414,7.699847528
7211,2,ìcë∫és,38500,40422,-1922,-4.754836475,458.33,84,12725,11933,792,6.637056901
7212,2,ìÏëäînés,57733,70878,-13145,-18.5459522,398.58,144.8,25891,23640,2251,9.521996616
7213,2,à…íBés,62436,66027,-3591,-5.438684175,265.12,235.5,21656,20870,786,3.766171538
7214,2,ñ{ã{és,30924,31489,-565,-1.794277367,88.02,351.3,10044,9538,506,5.305095408
7300,c,à…íBåS,36275,38508,-2233,-5.798795056,208.62,173.9,13059,12438,621,4.99276411
7301,3,åKê‹í¨,12277,12853,-576,-4.481444021,42.97,285.7,4269,4055,214,5.277435265
7303,3,çëå©í¨,9519,10086,-567,-5.621653778,37.95,250.8,3277,3204,73,2.278401998
7308,3,êÏñìí¨,14479,15569,-1090,-7.001091913,127.7,113.4,5513,5179,334,6.449121452
7320,c,à¿íBåS,8684,8574,110,1.282948449,79.44,109.3,2614,2253,361,16.02308034
7322,3,ëÂã ë∫,8684,8574,110,1.282948449,79.44,109.3,2614,2253,361,16.02308034
7340,c,ä‚ê£åS,18102,19106,-1004,-5.254893751,256.82,70.5,5835,5745,90,1.566579635
7342,3,ãæêŒí¨,12482,12815,-333,-2.598517363,31.3,398.8,4196,4076,120,2.944062807
7344,3,ìVâhë∫,5620,6291,-671,-10.66603084,225.52,24.9,1639,1669,-30,-1.797483523
7360,c,ìÏâÔí√åS,27117,29893,-2776,-9.286455023,2341.53,11.6,10226,10682,-456,-4.268863509
7362,3,â∫ãΩí¨,5786,6461,-675,-10.44729918,317.04,18.3,2003,2103,-100,-4.755111745
7364,3,ûwé}äÚë∫,614,636,-22,-3.459119497,390.46,1.6,222,221,1,0.452488688
7367,3,ë¸å©í¨,4470,4932,-462,-9.367396594,747.56,6,1759,1851,-92,-4.970286332
7368,3,ìÏâÔí√í¨,16247,17864,-1617,-9.051724138,886.47,18.3,6242,6507,-265,-4.072537268
7400,c,ñÎñÉåS,28021,30117,-2096,-6.959524521,986.88,28.4,9596,9790,-194,-1.981613892
7402,3,ñkâñå¥ë∫,2810,3185,-375,-11.77394035,234.08,12,1008,1052,-44,-4.182509506
7405,3,êºâÔí√í¨,6583,7366,-783,-10.62992126,298.18,22.1,2531,2653,-122,-4.598567659
7407,3,î÷íÚí¨,3581,3761,-180,-4.785961181,59.68,60,1117,1131,-14,-1.237842617
7408,3,íñïcë„í¨,15047,15805,-758,-4.795950649,394.94,38.1,4940,4954,-14,-0.282599919
7420,c,âÕè¿åS,23065,24733,-1668,-6.7440262,283.79,81.3,7506,7545,-39,-0.516898608
7421,3,âÔí√ç‚â∫í¨,16320,17360,-1040,-5.99078341,91.59,178.2,5381,5371,10,0.186185068
7422,3,ìíêÏë∫,3207,3364,-157,-4.66706302,16.37,195.9,906,915,-9,-0.983606557
7423,3,ñˆí√í¨,3538,4009,-471,-11.74856573,175.82,20.1,1219,1259,-40,-3.177124702
7440,c,ëÂè¿åS,26097,28625,-2528,-8.831441048,870.51,30,8968,9241,-273,-2.954225733
7444,3,éOìáí¨,1668,1926,-258,-13.39563863,90.81,18.4,683,747,-64,-8.567603748
7445,3,ã‡éRí¨,2175,2462,-287,-11.65718928,293.92,7.4,956,1042,-86,-8.253358925
7446,3,è∫òaë∫,1322,1500,-178,-11.86666667,209.46,6.3,616,646,-30,-4.643962848
7447,3,âÔí√î¸ó¢í¨,20932,22737,-1805,-7.938602278,276.33,75.8,6713,6806,-93,-1.366441375
7460,c,êºîíâÕåS,49269,50130,-861,-1.717534411,306.8,160.6,16816,16047,769,4.792172992
7461,3,êºãΩë∫,20328,19767,561,2.838063439,192.06,105.8,7459,6711,748,11.1458799
7464,3,êÚçËë∫,6494,6802,-308,-4.528079977,35.43,183.3,2050,2006,44,2.193419741
7465,3,íÜìáë∫,4995,5154,-159,-3.084982538,18.92,264,1394,1387,7,0.504686374
7466,3,ñÓêÅí¨,17452,18407,-955,-5.188243603,60.4,288.9,5913,5943,-30,-0.504795558
7480,c,ìåîíêÏåS,32960,35283,-2323,-6.583907264,620.95,53.1,10771,10832,-61,-0.563146233
7481,3,íIëqí¨,14302,15062,-760,-5.045810649,159.93,89.4,4734,4708,26,0.552251487
7482,3,ñÓç’í¨,5940,6348,-408,-6.427221172,118.27,50.2,1920,1932,-12,-0.621118012
7483,3,î∑í¨,9141,9884,-743,-7.517199514,211.41,43.2,3045,3086,-41,-1.328580687
7484,3,éLêÏë∫,3577,3989,-412,-10.32840311,131.34,27.2,1072,1106,-34,-3.074141049
7500,c,êŒêÏåS,41105,44845,-3740,-8.339837217,456.52,90,12944,13058,-114,-0.873028029
7501,3,êŒêÏí¨,15884,17775,-1891,-10.63853727,115.71,137.3,5246,5370,-124,-2.309124767
7502,3,ã êÏë∫,6773,7231,-458,-6.333840409,46.67,145.1,1978,1923,55,2.860114405
7503,3,ïΩìcë∫,6495,6921,-426,-6.155179887,93.42,69.5,1995,2008,-13,-0.647410359
7504,3,êÛêÏí¨,6577,6888,-311,-4.515098722,37.43,175.7,2065,2029,36,1.774273041
7505,3,å√ìaí¨,5376,6030,-654,-10.84577114,163.29,32.9,1660,1728,-68,-3.935185185
7520,c,ìcë∫åS,28772,29393,-621,-2.112747933,197.95,145.3,9644,8997,647,7.191285984
7521,3,éOètí¨,18305,18191,114,0.626683525,72.76,251.6,6230,5502,728,13.23155216
7522,3,è¨ñÏí¨,10467,11202,-735,-6.561328334,125.18,83.6,3414,3495,-81,-2.317596567
7540,c,ëoótåS,7338,72822,-65484,-89.9233748,865.71,8.5,4353,25471,-21118,-82.90997605
7541,3,çLñÏí¨,4323,5418,-1095,-20.21040975,58.69,73.7,2428,1810,618,34.14364641
7542,3,ìËótí¨,976,7700,-6724,-87.32467532,103.64,9.4,839,2576,-1737,-67.43012422
7543,3,ïxâ™í¨,0,16001,-16001,-100,68.39,0,0,6141,-6141,-100
7544,3,êÏì‡ë∫,2021,2820,-799,-28.33333333,197.35,10.2,1077,950,127,13.36842105
7545,3,ëÂåFí¨,0,11515,-11515,-100,78.71,0,0,3955,-3955,-100
7546,3,ëoótí¨,0,6932,-6932,-100,51.42,0,0,2393,-2393,-100
7547,3,òQç]í¨,0,20905,-20905,-100,223.14,0,0,7176,-7176,-100
7548,3,äãîˆë∫,18,1531,-1513,-98.82429784,84.37,0.2,9,470,-461,-98.08510638
7560,c,ëäînåS,8261,14433,-6172,-42.76311231,276.67,29.9,2694,4195,-1501,-35.7806913
7561,3,êVíní¨,8220,8224,-4,-0.048638132,46.53,176.7,2693,2461,232,9.42706217
7564,3,î—ä⁄ë∫,41,6209,-6168,-99.33966822,230.13,0.2,1,1734,-1733,-99.94232987
8000,a,àÔèÈåß,2917857,2969770,-51913,-1.748047829,6096.93,478.6,1123802,1088411,35391,3.251620941
8001,b,ésïî,2648189,2686813,-38624,-1.437539568,5090.18,520.3,1025872,990793,35079,3.540497359
8002,b,åSïî,269668,282957,-13289,-4.696473316,1006.76,267.9,97930,97618,312,0.319613186
8201,2,êÖåÀés,270823,268750,2073,0.771348837,217.32,1246.2,117564,112099,5465,4.875154997
8202,2,ì˙óßés,185149,193129,-7980,-4.131953254,225.71,820.3,78653,77965,688,0.882447252
8203,2,ìyâYés,140948,143839,-2891,-2.009886053,122.89,1146.9,57232,56663,569,1.004182624
8204,2,å√âÕés,140975,142995,-2020,-1.412636806,123.58,1140.8,52511,50465,2046,4.054295056
8205,2,êŒâ™és,76030,79687,-3657,-4.589205266,215.53,352.8,27275,27094,181,0.668044586
8207,2,åãèÈés,51605,52494,-889,-1.693526879,65.76,784.7,18228,17466,762,4.362761938
8208,2,ó¥ÉPçËés,78368,80334,-1966,-2.447282595,78.55,997.7,30445,30092,353,1.173069254
8210,2,â∫ç»és,43334,44987,-1653,-3.674394825,80.88,535.8,15025,14890,135,0.906648758
8211,2,èÌëçés,61460,65320,-3860,-5.909369259,123.64,497.1,20552,20685,-133,-0.642978003
8212,2,èÌó§ëæìcés,52326,56250,-3924,-6.976,371.99,140.7,19434,19801,-367,-1.853441745
8214,2,çÇîãés,29656,31017,-1361,-4.387916304,193.58,153.2,11716,11661,55,0.471657662
8215,2,ñkàÔèÈés,44443,47026,-2583,-5.492706163,186.8,237.9,16858,16966,-108,-0.636567252
8216,2,ä}ä‘és,76766,79409,-2643,-3.328338098,240.4,319.3,28178,27946,232,0.830172476
8217,2,éÊéËés,106564,109651,-3087,-2.815295802,69.94,1523.6,43458,42614,844,1.980569766
8219,2,ãçãvés,84454,81684,2770,3.391116987,58.92,1433.4,33270,31569,1701,5.388197282
8220,2,Ç¬Ç≠ÇŒés,227029,214590,12439,5.796635444,283.72,800.2,98138,87477,10661,12.18720349
8221,2,Ç–ÇΩÇøÇ»Ç©és,155680,157060,-1380,-0.878645104,99.83,1559.5,61196,60268,928,1.539788943
8222,2,é≠ìàés,67885,66093,1792,2.711331003,106.02,640.3,27451,25199,2252,8.936862574
8223,2,í™óàés,29105,30534,-1429,-4.68002882,71.4,407.6,10542,10384,158,1.521571649
8224,2,éÁíJés,64763,62482,2281,3.650651388,35.71,1813.6,24844,22854,1990,8.707447274
8225,2,èÌó§ëÂã{és,42587,45178,-2591,-5.735092302,348.45,122.2,16011,16087,-76,-0.472431156
8226,2,ìﬂâœés,54270,54240,30,0.055309735,97.82,554.8,20009,18889,1120,5.929376886
8227,2,í}êºés,104617,108527,-3910,-3.602790089,205.3,509.6,35666,35188,478,1.358417642
8228,2,ç‚ìåés,54073,56114,-2041,-3.637238479,123.03,439.5,17280,16763,517,3.084173477
8229,2,àÓï~és,42769,46895,-4126,-8.798379358,205.81,207.8,14427,14809,-382,-2.579512459
8230,2,Ç©Ç∑Ç›Ç™Ç§ÇÁés,42143,43553,-1410,-3.23743485,156.6,269.1,15113,14730,383,2.600135777
8231,2,ç˜êÏés,42651,45673,-3022,-6.616600617,180.06,236.9,13615,13632,-17,-0.124706573
8232,2,ê_ê≤és,94582,94795,-213,-0.224695395,146.94,643.7,37003,35901,1102,3.06955238
8233,2,çsï˚és,34915,37611,-2696,-7.168115711,222.48,156.9,11104,11346,-242,-2.132910277
8234,2,ñgìcés,48156,50156,-2000,-3.987558817,207.61,232,17374,16810,564,3.355145747
8235,2,Ç¬Ç≠ÇŒÇ›ÇÁÇ¢és,49146,44461,4685,10.53732485,79.16,620.8,18148,15273,2875,18.82406862
8236,2,è¨î¸ã és,50917,52279,-1362,-2.605252587,144.74,351.8,17552,17207,345,2.004997966
8300,c,ìåàÔèÈåS,69625,74332,-4707,-6.332400581,307.12,226.7,25077,25350,-273,-1.076923077
8302,3,àÔèÈí¨,32930,34513,-1583,-4.586677484,121.58,270.9,11354,11187,167,1.492804148
8309,3,ëÂêÙí¨,16891,18328,-1437,-7.84046268,23.74,711.5,6656,7021,-365,-5.198689645
8310,3,èÈó¢í¨,19804,21491,-1687,-7.84979759,161.8,122.4,7067,7142,-75,-1.050126015
8340,c,ìﬂâœåS,37716,37438,278,0.742561034,37.98,993,14476,14113,363,2.572096649
8341,3,ìåäCë∫,37716,37438,278,0.742561034,37.98,993,14476,14113,363,2.572096649
8360,c,ãvéúåS,18144,20073,-1929,-9.609923778,325.76,55.7,6734,7140,-406,-5.68627451
8364,3,ëÂéqí¨,18144,20073,-1929,-9.609923778,325.76,55.7,6734,7140,-406,-5.68627451
8440,c,àÓï~åS,72570,75411,-2841,-3.767354895,182.3,398.1,27741,27278,463,1.697338515
8442,3,î¸âYë∫,15851,17299,-1448,-8.370426036,66.61,238,5975,6305,-330,-5.233941316
8443,3,à¢å©í¨,47545,47940,-395,-0.8239466,71.4,665.9,18820,17969,851,4.735934109
8447,3,âÕì‡í¨,9174,10172,-998,-9.811246559,44.3,207.1,2946,3004,-58,-1.930758988
8520,c,åãèÈåS,22008,23106,-1098,-4.752012464,58.99,373.1,6814,6756,58,0.858496152
8521,3,î™êÁë„í¨,22008,23106,-1098,-4.752012464,58.99,373.1,6814,6756,58,0.858496152
8540,c,âéìáåS,33304,35124,-1820,-5.181642182,69.7,477.8,10958,10850,108,0.995391705
8542,3,å‹â‡í¨,8784,9410,-626,-6.652497343,23.11,380.1,2890,2927,-37,-1.264092928
8546,3,ã´í¨,24520,25714,-1194,-4.643384927,46.59,526.3,8068,7923,145,1.830114856
8560,c,ñkëäînåS,16301,17473,-1172,-6.707491558,24.9,654.7,6130,6131,-1,-0.016310553
8564,3,óòç™í¨,16301,17473,-1172,-6.707491558,24.9,654.7,6130,6131,-1,-0.016310553
9000,a,ì»ñÿåß,1974671,2007683,-33012,-1.644283485,6408.09,308.2,762535,745604,16931,2.270776444
9001,b,ésïî,1731913,1755040,-23127,-1.317747744,5053.84,342.7,675973,660748,15225,2.304206748
9002,b,åSïî,242758,252643,-9885,-3.912635616,1354.25,179.3,86562,84856,1706,2.010464787
9201,2,âFìsã{és,518761,511739,7022,1.372183867,416.85,1244.5,217372,210482,6890,3.273439059
9202,2,ë´óòés,149504,154530,-5026,-3.252442891,177.76,841,60111,59134,977,1.652179795
9203,2,ì»ñÿés,159267,164024,-4757,-2.900185339,331.5,480.4,57745,56489,1256,2.223441732
9204,2,ç≤ñÏés,118919,121249,-2330,-1.921665333,356.04,334,46330,45178,1152,2.549913675
9205,2,é≠è¿és,98384,102348,-3964,-3.873060539,490.64,200.5,35060,34999,61,0.174290694
9206,2,ì˙åıés,83446,90066,-6620,-7.350165434,1449.83,57.6,32654,33926,-1272,-3.749336792
9208,2,è¨éRés,166795,164454,2341,1.423498364,171.76,971.1,65727,62844,2883,4.587550124
9209,2,ê^â™és,79579,82289,-2710,-3.293271276,167.34,475.6,27934,27577,357,1.294557058
9210,2,ëÂìcå¥és,75480,77729,-2249,-2.893385995,354.36,213,28743,28075,668,2.379341051
9211,2,ñÓî¬és,33362,35343,-1981,-5.605070311,170.46,195.7,12275,12438,-163,-1.31050008
9213,2,ìﬂê{âñå¥és,117044,117812,-768,-0.651886056,592.74,197.5,45563,44602,961,2.154611901
9214,2,Ç≥Ç≠ÇÁés,44916,44768,148,0.330593281,125.63,357.5,15630,14917,713,4.779781457
9215,2,ìﬂê{âGéRés,27012,29206,-2194,-7.512155037,174.35,154.9,9480,9586,-106,-1.105779261
9216,2,â∫ñÏés,59444,59483,-39,-0.065564951,74.59,796.9,21349,20501,848,4.136383591
9300,c,âÕì‡åS,31055,31621,-566,-1.789949717,54.39,571,10737,10390,347,3.339749759
9301,3,è„éOêÏí¨,31055,31621,-566,-1.789949717,54.39,571,10737,10390,347,3.339749759
9340,c,ñFâÍåS,63412,67490,-4078,-6.042376648,396.5,159.9,21430,21525,-95,-0.441347271
9342,3,âvéqí¨,23299,24348,-1049,-4.308362083,89.4,260.6,7785,7801,-16,-0.20510191
9343,3,ñŒñÿí¨,13188,15018,-1830,-12.18537755,172.69,76.4,4569,4799,-230,-4.792665139
9344,3,ésäLí¨,11724,12094,-370,-3.059368282,64.25,182.5,4102,4018,84,2.090592335
9345,3,ñFâÍí¨,15201,16030,-829,-5.171553338,70.16,216.7,4974,4907,67,1.365396373
9360,c,â∫ìsâÍåS,65254,65325,-71,-0.108687333,91.32,714.6,24782,23336,1446,6.196434693
9361,3,êpê∂í¨,39944,39605,339,0.855952531,61.06,654.2,15216,14214,1002,7.049387927
9364,3,ñÏñÿí¨,25310,25720,-410,-1.594090202,30.26,836.4,9566,9122,444,4.867353651
9380,c,âñíJåS,41152,42996,-1844,-4.288771049,246.92,166.7,15199,15029,170,1.13114645
9384,3,âñíJí¨,11496,12560,-1064,-8.47133758,176.06,65.3,3687,3828,-141,-3.68338558
9386,3,çÇç™ëÚí¨,29656,30436,-780,-2.562754633,70.87,418.5,11512,11201,311,2.776537809
9400,c,ìﬂê{åS,41885,45211,-3326,-7.356616753,565.12,74.1,14414,14576,-162,-1.111416026
9407,3,ìﬂê{í¨,24922,26765,-1843,-6.885858397,372.34,66.9,8583,8699,-116,-1.333486608
9411,3,ìﬂâœêÏí¨,16963,18446,-1483,-8.0396834,192.78,88,5831,5877,-46,-0.782712268
10000,a,åQînåß,1973476,2008068,-34592,-1.722650827,6362.28,310.2,773186,755756,17430,2.306299917
10001,b,ésïî,1679197,1703207,-24010,-1.409693596,2892.74,580.5,661341,646224,15117,2.339281735
10002,b,åSïî,294279,304861,-10582,-3.471090103,3469.55,84.8,111845,109532,2313,2.111711646
10201,2,ëOã¥és,336199,340291,-4092,-1.202500213,311.59,1079,136747,133322,3425,2.568968362
10202,2,çÇçËés,370751,371302,-551,-0.148396723,459.16,807.5,150464,147116,3348,2.275755186
10203,2,ãÀê∂és,114760,121704,-6944,-5.705646487,274.45,418.1,46021,46688,-667,-1.428632625
10204,2,à…ê®çËés,208838,207221,1617,0.780326318,139.44,1497.7,79852,76527,3325,4.344871745
10205,2,ëæìcés,219896,216465,3431,1.585013744,175.54,1252.7,86134,81437,4697,5.767648612
10206,2,è¿ìcés,48697,51265,-2568,-5.009265581,443.46,109.8,19106,19148,-42,-0.219344057
10207,2,äŸó—és,76676,78608,-1932,-2.457765113,60.97,1257.6,30205,29581,624,2.109462155
10208,2,èaêÏés,78426,83330,-4904,-5.885035401,240.27,326.4,28808,29290,-482,-1.645612837
10209,2,ì°â™és,65723,67975,-2252,-3.312982714,180.29,364.5,24549,24298,251,1.033006832
10210,2,ïxâ™és,49760,52070,-2310,-4.436335702,122.85,405,18252,18297,-45,-0.245941958
10211,2,à¿íÜés,58529,61077,-2548,-4.171783159,276.31,211.8,22377,22184,193,0.869996394
10212,2,Ç›Ç«ÇËés,50942,51899,-957,-1.843966165,208.42,244.4,18826,18336,490,2.672338569
10340,c,ñkåQînåS,35424,34171,1253,3.666852009,48.38,732.2,12167,11164,1003,8.984235041
10344,3,êYìåë∫,14338,14370,-32,-0.222686152,27.92,513.5,4883,4634,249,5.373327579
10345,3,ãgâ™í¨,21086,19801,1285,6.489571234,20.46,1030.6,7284,6530,754,11.5467075
10360,c,ëΩñÏåS,3184,3658,-474,-12.95790049,296.44,10.7,1480,1650,-170,-10.3030303
10366,3,è„ñÏë∫,1228,1306,-78,-5.972434916,181.85,6.8,577,612,-35,-5.718954248
10367,3,ê_ó¨í¨,1956,2352,-396,-16.83673469,114.6,17.1,903,1038,-135,-13.00578035
10380,c,ä√äyåS,22823,24952,-2129,-8.532382174,365.81,62.4,8532,8851,-319,-3.60411253
10382,3,â∫êmìcí¨,7633,8911,-1278,-14.34182471,188.38,40.5,3040,3316,-276,-8.323281062
10383,3,ìÏñqë∫,1980,2423,-443,-18.2831201,118.83,16.7,953,1088,-135,-12.40808824
10384,3,ä√äyí¨,13210,13618,-408,-2.99603466,58.61,225.4,4539,4447,92,2.068810434
10420,c,å·ç»åS,56413,61109,-4696,-7.684629105,1278.55,44.1,22022,22726,-704,-3.097773475
10421,3,íÜîVèí¨,16842,18216,-1374,-7.542819499,439.28,38.3,6516,6608,-92,-1.392251816
10424,3,í∑ñÏå¥í¨,5477,6017,-540,-8.974572046,133.85,40.9,2183,2295,-112,-4.880174292
10425,3,í⁄óˆë∫,9787,10183,-396,-3.888834332,337.58,29,3659,3651,8,0.21911805
10426,3,ëêí√í¨,6512,7160,-648,-9.05027933,49.75,130.9,3244,3474,-230,-6.620610248
10428,3,çÇéRë∫,3679,3911,-232,-5.931986704,64.18,57.3,1167,1179,-12,-1.017811705
10429,3,ìåå·ç»í¨,14116,15622,-1506,-9.640250928,253.91,55.6,5253,5519,-266,-4.819713716
10440,c,óòç™åS,34749,37767,-3018,-7.991103344,1322.23,26.3,12631,12944,-313,-2.418108776
10443,3,ï–ïië∫,4390,4904,-514,-10.4812398,391.76,11.2,1558,1677,-119,-7.09600477
10444,3,êÏèÍë∫,3648,3898,-250,-6.413545408,85.25,42.8,997,974,23,2.361396304
10448,3,è∫òaë∫,7355,7620,-265,-3.477690289,64.14,114.7,2474,2429,45,1.852614245
10449,3,Ç›Ç»Ç©Ç›í¨,19356,21345,-1989,-9.318341532,781.08,24.8,7602,7864,-262,-3.331637843
10460,c,ç≤îgåS,36653,37536,-883,-2.352408355,25.78,1421.8,14266,13857,409,2.95157682
10464,3,ã ë∫í¨,36653,37536,-883,-2.352408355,25.78,1421.8,14266,13857,409,2.95157682
10520,c,óWäyåS,105033,105668,-635,-0.600938789,132.36,793.5,40747,38340,2407,6.278038602
10521,3,î¬ëqí¨,15024,15706,-682,-4.342289571,41.86,358.9,5355,5129,226,4.406317021
10522,3,ñæòaí¨,11042,11209,-167,-1.489874208,19.64,562.2,3904,3696,208,5.627705628
10523,3,êÁë„ìcí¨,11331,11473,-142,-1.237688486,21.73,521.4,3937,3719,218,5.861790804
10524,3,ëÂêÚí¨,41213,40257,956,2.374742281,18.03,2285.8,18021,16600,1421,8.560240964
10525,3,óWäyí¨,26423,27023,-600,-2.220330829,31.11,849.3,9530,9196,334,3.632013919
11000,a,çÈã åß,7261271,7194556,66715,0.927298363,3797.75,1912,2968978,2841595,127383,4.482799273
11001,b,ésïî,6755544,6672510,83034,1.244419267,2823.05,2393,2779535,2656286,123249,4.639899469
11002,b,åSïî,505727,522046,-16319,-3.125969742,974.7,518.9,189443,185309,4134,2.230868441
11100,1,Ç≥Ç¢ÇΩÇ‹és,1264253,1222434,41819,3.420961786,217.43,5814.5,533427,503126,30301,6.022547036
11101,0,Ç≥Ç¢ÇΩÇ‹és êºãÊ,87156,84029,3127,3.721334301,29.12,2993,33914,31406,2508,7.98573521
11102,0,Ç≥Ç¢ÇΩÇ‹és ñkãÊ,143628,138630,4998,3.605280242,16.86,8518.9,61753,58382,3371,5.774039944
11103,0,Ç≥Ç¢ÇΩÇ‹és ëÂã{ãÊ,113794,108488,5306,4.890863506,12.8,8890.2,53218,48475,4743,9.784424961
11104,0,Ç≥Ç¢ÇΩÇ‹és å©è¿ãÊ,162013,157143,4870,3.099088092,30.69,5279,65661,61585,4076,6.618494763
11105,0,Ç≥Ç¢ÇΩÇ‹és íÜâõãÊ,98750,96055,2695,2.805684243,8.39,11770,42838,41153,1685,4.094476709
11106,0,Ç≥Ç¢ÇΩÇ‹és ç˜ãÊ,97943,96911,1032,1.064894594,18.64,5254.5,43472,42442,1030,2.426841336
11107,0,Ç≥Ç¢ÇΩÇ‹és âYòaãÊ,154393,144786,9607,6.635310044,11.51,13413.8,67100,61994,5106,8.23628093
11108,0,Ç≥Ç¢ÇΩÇ‹és ìÏãÊ,180180,174988,5192,2.967060598,13.82,13037.6,77790,74885,2905,3.879281565
11109,0,Ç≥Ç¢ÇΩÇ‹és óŒãÊ,116562,110118,6444,5.851904321,26.44,4408.5,44460,40862,3598,8.805246929
11110,0,Ç≥Ç¢ÇΩÇ‹és ä‚íŒãÊ,109834,111286,-1452,-1.304746329,49.17,2233.8,43221,41942,1279,3.049449239
11201,2,êÏâzés,350327,342670,7657,2.234511337,109.13,3210.2,145690,137121,8569,6.249225137
11202,2,åFíJés,198639,203180,-4541,-2.234964071,159.82,1242.9,77079,75413,1666,2.209168181
11203,2,êÏå˚és,578245,561506,16739,2.98109014,61.95,9334.1,245482,234124,11358,4.851275393
11206,2,çsìcés,82142,85786,-3644,-4.247779358,67.49,1217.1,30995,30630,365,1.191642181
11207,2,íÅïÉés,63545,66955,-3410,-5.092972892,577.83,110,24039,24146,-107,-0.44313758
11208,2,èäëÚés,335875,341924,-6049,-1.769106585,72.11,4657.8,144970,141225,3745,2.651796778
11209,2,î—î\és,80735,83549,-2814,-3.3680834,193.05,418.2,31744,30905,839,2.714771073
11210,2,â¡ê{és,112302,115002,-2700,-2.347785256,133.3,842.5,40735,39460,1275,3.231120122
11211,2,ñ{èØés,77885,81889,-4004,-4.889545604,89.69,868.4,30945,32217,-1272,-3.948226092
11212,2,ìåèºéRés,91445,90099,1346,1.493912252,65.35,1399.3,37240,34945,2295,6.567463156
11214,2,ètì˙ïîés,232372,237171,-4799,-2.023434568,66,3520.8,94399,91531,2868,3.133364652
11215,2,ã∑éRés,152393,155727,-3334,-2.140926108,48.99,3110.7,61983,61039,944,1.546552204
11216,2,âHê∂és,54984,56204,-1220,-2.17066401,58.64,937.7,20430,19473,957,4.914496996
11217,2,çÉëÉés,118122,119639,-1517,-1.267981177,67.44,1751.5,45009,43379,1630,3.757578552
11218,2,ê[íJés,143833,144618,-785,-0.542809332,138.37,1039.5,53343,50859,2484,4.884091311
11219,2,è„îˆés,225186,223926,1260,0.562685887,45.51,4948.1,91270,87286,3984,4.564305845
11221,2,ëêâ¡és,247076,243855,3221,1.320866909,27.46,8997.7,106072,102479,3593,3.506084173
11222,2,âzíJés,337562,326313,11249,3.447303662,60.24,5603.6,136528,128342,8186,6.378270558
11223,2,ònés,72240,71502,738,1.032138961,5.11,14137,33979,33112,867,2.618386084
11224,2,åÀìcés,136083,123079,13004,10.56557171,18.19,7481.2,59314,54495,4819,8.843013121
11225,2,ì¸ä‘és,148438,149872,-1434,-0.956816483,44.69,3321.5,58965,56843,2122,3.733089387
11227,2,í©â‡és,136041,129691,6350,4.896253402,18.34,7417.7,59510,56790,2720,4.78957563
11228,2,éuñÿés,72656,69611,3045,4.374308658,9.05,8028.3,30597,28433,2164,7.610874688
11229,2,òaåıés,80754,80745,9,0.011146201,11.04,7314.7,36847,37385,-538,-1.439079845
11230,2,êVç¿és,162181,158777,3404,2.143887339,22.78,7119.4,67153,64436,2717,4.216587001
11231,2,â±êÏés,73932,74711,-779,-1.042684478,25.35,2916.4,28521,28047,474,1.690020323
11232,2,ãväÏés,151904,154310,-2406,-1.559199015,82.41,1843.3,59420,57238,2182,3.812152766
11233,2,ñkñ{és,67414,68888,-1474,-2.139705029,19.82,3401.3,26823,25856,967,3.739944307
11234,2,î™í™és,86670,82977,3693,4.450630898,18.02,4809.7,35860,32467,3393,10.45061139
11235,2,ïxémå©és,108104,106736,1368,1.281666917,19.77,5468.1,47163,44642,2521,5.647148425
11237,2,éOãΩés,136528,131415,5113,3.890727847,30.13,4531.3,55179,51132,4047,7.91480873
11238,2,ò@ìcés,62387,63309,-922,-1.456349018,27.28,2286.9,24503,23445,1058,4.512689273
11239,2,ç‚åÀés,101648,101700,-52,-0.051130777,41.02,2478,42728,41508,1220,2.939192445
11240,2,çKéËés,52535,54012,-1477,-2.734577501,33.93,1548.3,20558,19904,654,3.285771704
11241,2,íﬂÉñìáés,70267,69990,277,0.395770824,17.65,3981.1,28627,27746,881,3.175232466
11242,2,ì˙çÇés,56521,57473,-952,-1.656429976,47.48,1190.4,21998,21227,771,3.63216658
11243,2,ãgêÏés,69759,65298,4461,6.83175595,31.66,2203.4,25681,23248,2433,10.46541638
11245,2,Ç”Ç∂Ç›ñÏés,111011,105695,5316,5.029566205,14.64,7582.7,45583,42763,2820,6.594485887
11246,2,îíâ™és,51550,50272,1278,2.542170592,24.92,2068.6,19146,17869,1277,7.146454754
11300,c,ñkë´óßåS,44434,42494,1940,4.565350402,14.79,3004.3,16683,15504,1179,7.604489164
11301,3,à…ìﬁí¨,44434,42494,1940,4.565350402,14.79,3004.3,16683,15504,1179,7.604489164
11320,c,ì¸ä‘åS,87439,90297,-2858,-3.16511069,89.79,973.8,34497,34150,347,1.016105417
11324,3,éOñFí¨,38459,38706,-247,-0.638143957,15.33,2508.7,14353,13940,413,2.962697274
11326,3,ñ—òCéRí¨,37289,39054,-1765,-4.519383418,34.07,1094.5,15595,15644,-49,-0.313219126
11327,3,âzê∂í¨,11691,12537,-846,-6.748025844,40.39,289.5,4549,4566,-17,-0.372317127
11340,c,î‰äÈåS,133901,140072,-6171,-4.40559141,281.86,475.1,49120,48071,1049,2.182188846
11341,3,ääêÏí¨,18211,17323,888,5.126132887,29.68,613.6,6712,6186,526,8.503071452
11342,3,óíéRí¨,18346,18887,-541,-2.864404088,29.92,613.2,6987,6708,279,4.15921288
11343,3,è¨êÏí¨,31193,32913,-1720,-5.225898581,60.36,516.8,11998,11645,353,3.031343924
11346,3,êÏìáí¨,20669,22147,-1478,-6.673590103,41.63,496.5,7113,7112,1,0.014060742
11347,3,ãgå©í¨,19635,21079,-1444,-6.850419849,38.64,508.2,6817,6804,13,0.19106408
11348,3,îµéRí¨,14347,15305,-958,-6.259392355,25.73,557.6,5310,5335,-25,-0.468603561
11349,3,Ç∆Ç´Ç™ÇÌí¨,11500,12418,-918,-7.392494766,55.9,205.7,4183,4281,-98,-2.28918477
11360,c,íÅïÉåS,41020,44619,-3599,-8.066070508,351.84,116.6,14800,15131,-331,-2.187561959
11361,3,â°ê£í¨,8520,9039,-519,-5.741785596,49.36,172.6,3060,3078,-18,-0.584795322
11362,3,äFñÏí¨,10128,10888,-760,-6.980161646,63.74,158.9,3657,3762,-105,-2.791068581
11363,3,í∑ì“í¨,7326,7908,-582,-7.359635812,30.43,240.7,2644,2713,-69,-2.543309989
11365,3,è¨é≠ñÏí¨,12105,13436,-1331,-9.90622209,171.26,70.7,4407,4503,-96,-2.131912059
11369,3,ìåíÅïÉë∫,2941,3348,-407,-12.15651135,37.06,79.4,1032,1075,-43,-4
11380,c,éôã åS,55399,57073,-1674,-2.933085697,109.99,503.7,19789,19438,351,1.805741331
11381,3,î¸ó¢í¨,11211,11605,-394,-3.395088324,33.41,335.6,3577,3550,27,0.76056338
11383,3,ê_êÏí¨,13704,14470,-766,-5.293711127,47.4,289.1,5026,5001,25,0.49990002
11385,3,è„ó¢í¨,30484,30998,-514,-1.658171495,29.18,1044.7,11186,10887,299,2.746394783
11400,c,ëÂó¢åS,34092,35774,-1682,-4.701738693,64.25,530.6,12922,12694,228,1.796124153
11408,3,äÒãèí¨,34092,35774,-1682,-4.701738693,64.25,530.6,12922,12694,228,1.796124153
11440,c,ìÏçÈã åS,33859,33641,218,0.648018787,15.95,2122.8,13782,13190,592,4.488248673
11442,3,ã{ë„í¨,33859,33641,218,0.648018787,15.95,2122.8,13782,13190,592,4.488248673
11460,c,ñkäãè¸åS,75583,78076,-2493,-3.193042676,46.23,1634.9,27850,27131,719,2.650105046
11464,3,êôåÀí¨,45521,46923,-1402,-2.987873751,30.03,1515.9,17232,16704,528,3.16091954
11465,3,èºïöí¨,30062,31153,-1091,-3.502070427,16.2,1855.7,10618,10427,191,1.831782871
12000,a,êÁótåß,6224027,6216289,7738,0.124479412,5157.64,1206.8,2607079,2515904,91175,3.623945906
12001,b,ésïî,6013794,5993522,20272,0.338231844,4405.57,1365,2529114,2438392,90722,3.720566669
12002,b,åSïî,210233,222767,-12534,-5.626506619,752.07,279.5,77965,77512,453,0.584425637
12100,1,êÁótés,972639,961749,10890,1.132312069,271.76,3579,417640,406309,11331,2.788764216
12101,0,êÁótés íÜâõãÊ,205187,199364,5823,2.920788106,44.69,4591.3,95248,93614,1634,1.745465422
12102,0,êÁótés â‘å©êÏãÊ,179286,180949,-1663,-0.919043487,34.19,5243.8,77544,76051,1493,1.963156303
12103,0,êÁótés àÓñ—ãÊ,161162,157768,3394,2.151260078,21.22,7594.8,71072,68503,2569,3.750200721
12104,0,êÁótés é·ótãÊ,151306,151585,-279,-0.184055151,84.21,1796.8,63054,61484,1570,2.553509856
12105,0,êÁótés óŒãÊ,126931,121921,5010,4.109218264,66.25,1915.9,46760,44004,2756,6.263066994
12106,0,êÁótés î¸ïlãÊ,148767,150162,-1395,-0.928996684,21.2,7017.3,63962,62653,1309,2.089285429
12202,2,í∂éqés,64431,70210,-5779,-8.231021222,84.19,765.3,26131,27035,-904,-3.343813575
12203,2,ésêÏés,481492,473919,7573,1.597952393,57.45,8381.1,228684,220582,8102,3.67301049
12204,2,ëDã¥és,622823,609040,13783,2.263069749,85.62,7274.3,271786,261415,10371,3.967255131
12205,2,äŸéRés,47488,49290,-1802,-3.655913979,110.15,431.1,20143,20232,-89,-0.439897193
12206,2,ñÿçXí√és,134175,129312,4863,3.760671863,138.94,965.7,54843,50042,4801,9.59394109
12207,2,èºåÀés,483238,484457,-1219,-0.251621919,61.38,7872.9,215464,209570,5894,2.812425443
12208,2,ñÏìcés,153609,155491,-1882,-1.210359442,103.55,1483.4,59654,58050,1604,2.763135228
12210,2,ñŒå¥és,89730,93015,-3285,-3.531688437,99.92,898,36023,35936,87,0.242097061
12211,2,ê¨ìcés,131230,128933,2297,1.781545454,213.84,613.7,55421,52894,2527,4.777479487
12212,2,ç≤ëqés,172789,172183,606,0.351951122,103.69,1666.4,69041,65035,4006,6.159760129
12213,2,ìåã‡és,60671,61751,-1080,-1.748959531,89.12,680.8,25094,24378,716,2.937074411
12215,2,àÆés,66601,69058,-2457,-3.557878884,130.45,510.5,23318,23157,161,0.695254135
12216,2,èKéuñÏés,168033,164530,3503,2.129094998,20.97,8013,72213,70132,2081,2.967261735
12217,2,îêés,414054,404012,10042,2.485569736,114.74,3608.6,175479,162287,13192,8.128808839
12218,2,èüâYés,19258,20788,-1530,-7.360015394,93.96,205,8980,9179,-199,-2.167992156
12219,2,éså¥és,274558,280416,-5858,-2.089039142,368.17,745.7,113664,111973,1691,1.510185491
12220,2,ó¨éRés,174417,163984,10433,6.362206069,35.32,4938.2,70733,64921,5812,8.952419094
12221,2,î™êÁë„és,193219,189781,3438,1.811561748,51.39,3759.9,78206,74824,3382,4.519940126
12222,2,â‰ë∑éqés,131653,134017,-2364,-1.763955319,43.15,3051.1,54044,53170,874,1.643784089
12223,2,äõêÏés,33954,35766,-1812,-5.06626405,191.14,177.6,14445,14361,84,0.584917485
12224,2,äôÉPíJés,108979,107853,1126,1.044013611,21.08,5169.8,44127,41955,2172,5.176975331
12225,2,åNí√és,86055,89168,-3113,-3.491162749,318.81,269.9,34459,33908,551,1.624985254
12226,2,ïxí√és,45616,48073,-2457,-5.110977056,205.53,221.9,17621,17311,310,1.790768875
12227,2,âYà¿és,164086,164877,-791,-0.479751572,17.3,9484.7,73996,71411,2585,3.619890493
12228,2,éläXìπés,89272,86726,2546,2.935682494,34.52,2586.1,34757,32514,2243,6.898566771
12229,2,ë≥ÉPâYés,60964,60355,609,1.009029906,94.93,642.2,22650,21561,1089,5.050786142
12230,2,î™äXés,70806,73212,-2406,-3.286346501,74.94,944.8,27088,25838,1250,4.837835746
12231,2,àÛêºés,92684,88176,4508,5.112502268,123.79,748.7,32583,29622,2961,9.995948957
12232,2,îíà‰és,61729,60345,1384,2.293479162,35.48,1739.8,22665,21207,1458,6.875088414
12233,2,ïxó¢és,49656,51087,-1431,-2.801103999,53.88,921.6,20008,19701,307,1.558296533
12234,2,ìÏñ[ëçés,39044,42104,-3060,-7.267718032,230.14,169.7,15052,15575,-523,-3.357945425
12235,2,ëxç∫és,37273,39814,-2541,-6.382177124,101.52,367.1,12699,12873,-174,-1.351666278
12236,2,çÅéÊés,77526,82866,-5340,-6.44413873,262.35,295.5,27263,27309,-46,-0.168442638
12237,2,éRïêés,52231,56089,-3858,-6.878354045,146.77,355.9,19448,19286,162,0.839987556
12238,2,Ç¢Ç∑Ç›és,38620,40962,-2342,-5.717494263,157.44,245.3,14845,14704,141,0.958922742
12239,2,ëÂñ‘îíó¢és,49191,50113,-922,-1.839841957,58.08,847,18847,18135,712,3.926109733
12320,c,àÛù◊åS,42212,43814,-1602,-3.656365545,51.52,819.3,17130,16575,555,3.34841629
12322,3,éÅXà‰í¨,20972,21234,-262,-1.233870208,19.01,1103.2,8946,8571,375,4.375218761
12329,3,âhí¨,21240,22580,-1340,-5.93445527,32.51,653.3,8184,8004,180,2.248875562
12340,c,çÅéÊåS,35032,37610,-2578,-6.854559958,138.95,252.1,11811,11841,-30,-0.25335698
12342,3,ê_çËí¨,6142,6454,-312,-4.834211342,19.9,308.6,2205,2135,70,3.278688525
12347,3,ëΩå√í¨,14738,16002,-1264,-7.899012623,72.8,202.4,5049,5145,-96,-1.865889213
12349,3,ìåèØí¨,14152,15154,-1002,-6.612115613,46.25,306,4557,4561,-4,-0.087700066
12400,c,éRïêåS,47728,50599,-2871,-5.674025178,134.7,354.3,17307,17369,-62,-0.356957798
12403,3,ã„è\ã„ó¢í¨,16521,18004,-1483,-8.237058432,24.45,675.7,6425,6621,-196,-2.960277904
12409,3,é≈éRí¨,7440,7920,-480,-6.060606061,43.24,172.1,2449,2470,-21,-0.850202429
12410,3,â°é≈åıí¨,23767,24675,-908,-3.679837893,67.01,354.7,8433,8278,155,1.872432955
12420,c,í∑ê∂åS,60074,63385,-3311,-5.223633352,226.97,264.7,21899,21554,345,1.600630973
12421,3,àÍã{í¨,11770,12034,-264,-2.193784278,22.97,512.4,4485,4393,92,2.094240838
12422,3,ñrëÚí¨,7228,7340,-112,-1.525885559,35.59,203.1,2439,2400,39,1.625
12423,3,í∑ê∂ë∫,14372,14752,-380,-2.575921909,28.29,508,5418,5032,386,7.6709062
12424,3,îíéqí¨,11160,12151,-991,-8.155707349,27.5,405.8,4182,4274,-92,-2.152550304
12426,3,í∑ïøí¨,7338,8035,-697,-8.674548849,47.11,155.8,2586,2639,-53,-2.008336491
12427,3,í∑ìÏí¨,8206,9073,-867,-9.555824975,65.51,125.3,2789,2816,-27,-0.958806818
12440,c,àŒã˜åS,17163,18409,-1246,-6.768428486,154.73,110.9,6493,6693,-200,-2.988196623
12441,3,ëÂëΩäÏí¨,9850,10671,-821,-7.693749414,129.87,75.8,3444,3584,-140,-3.90625
12443,3,å‰èhí¨,7313,7738,-425,-5.492375291,24.86,294.2,3049,3109,-60,-1.929880991
12460,c,à¿ñ[åS,8024,8950,-926,-10.34636872,45.19,177.6,3325,3480,-155,-4.454022989
12463,3,ãòìÏí¨,8024,8950,-926,-10.34636872,45.19,177.6,3325,3480,-155,-4.454022989
13000,a,ìåãûìs,13513734,13159417,354317,2.6924977,2190.9,6168.1,6692089,6393781,298308,4.665596147
13001,b,ésïî,13429011,13072852,356159,2.724416983,1410.9,9518,6656842,6359147,297695,4.681366856
13002,b,åSïî,84723,86565,-1842,-2.127880783,780,108.6,35247,34634,613,1.769937056
13100,1,ì¡ï ãÊïî,9272565,8945695,326870,3.653936335,626.7,14795.9,4793379,4540746,252633,5.563689315
13101,0,êÁë„ìcãÊ,58344,47115,11229,23.83317415,11.66,5003.8,33361,25560,7801,30.52034429
13102,0,íÜâõãÊ,141087,122762,18325,14.92725762,10.21,13818.5,79184,67981,11203,16.4796046
13103,0,ç`ãÊ,243390,205131,38259,18.65100838,20.37,11948.5,130386,110113,20273,18.41108679
13104,0,êVèhãÊ,333363,326309,7054,2.161754656,18.22,18296.5,203831,195434,8397,4.296591177
13105,0,ï∂ãûãÊ,219806,206626,13180,6.378674513,11.29,19469.1,120640,111753,8887,7.952359221
13106,0,ë‰ìåãÊ,198512,175928,22584,12.83706971,10.11,19635.2,111887,95413,16474,17.26599101
13107,0,ñnìcãÊ,256416,247606,8810,3.558072098,13.77,18621.4,130338,120797,9541,7.89837496
13108,0,ç]ìåãÊ,498144,460819,37325,8.09970943,40.16,12404,244482,214424,30058,14.01802037
13109,0,ïiêÏãÊ,386687,365302,21385,5.854060476,22.84,16930.3,212322,196132,16190,8.254644831
13110,0,ñ⁄çïãÊ,278105,268330,9775,3.642902396,14.67,18957.4,144873,138028,6845,4.959138726
13111,0,ëÂìcãÊ,717565,693373,24192,3.489031156,60.66,11829.3,371447,345608,25839,7.476389435
13112,0,ê¢ìcíJãÊ,900391,877138,23253,2.651008165,58.05,15510.6,462335,448961,13374,2.978877898
13113,0,èaíJãÊ,224815,204492,20323,9.938286094,15.11,14878.6,135498,123746,11752,9.496872626
13114,0,íÜñÏãÊ,328685,314750,13935,4.427323272,15.59,21083.1,195630,184267,11363,6.166595212
13115,0,êôï¿ãÊ,564846,549569,15277,2.779814728,34.06,16583.9,312413,302805,9608,3.172999125
13116,0,ñLìáãÊ,291066,284678,6388,2.243938766,13.01,22372.5,176104,166214,9890,5.950160636
13117,0,ñkãÊ,341074,335544,5530,1.64807,20.61,16549,176873,172568,4305,2.494668768
13118,0,çrêÏãÊ,211518,203296,8222,4.044349126,10.16,20818.7,101752,96161,5591,5.814207423
13119,0,î¬ã¥ãÊ,561937,535824,26113,4.873428589,32.22,17440.6,291659,272683,18976,6.958996344
13120,0,ó˚înãÊ,722108,716124,5984,0.835609476,48.08,15018.9,337824,336163,1661,0.494105538
13121,0,ë´óßãÊ,671108,683426,-12318,-1.802389725,53.25,12603,310852,314618,-3766,-1.197007164
13122,0,äãè¸ãÊ,443293,442586,707,0.159742965,34.8,12738.3,201360,197276,4084,2.070196071
13123,0,ç]åÀêÏãÊ,680305,678967,1338,0.197064069,49.9,13633.4,308328,304041,4287,1.410007203
13201,2,î™â§éqés,576526,580053,-3527,-0.608047885,186.38,3093.3,254008,249893,4115,1.64670479
13202,2,óßêÏés,175388,179668,-4280,-2.382171561,24.36,7199.8,83355,80916,2439,3.014236987
13203,2,ïêë†ñÏés,144683,138734,5949,4.288062047,10.98,13177,73981,71228,2753,3.865053069
13204,2,éOëÈés,187133,186083,1050,0.564264334,16.42,11396.7,90396,90190,206,0.228406697
13205,2,ê¬î~és,137177,139339,-2162,-1.551611537,103.31,1327.8,54344,52544,1800,3.425700365
13206,2,ï{íÜés,260132,255506,4626,1.810524998,29.43,8839,119391,115166,4225,3.668617474
13207,2,è∫ìáés,111511,112297,-786,-0.699929651,17.34,6430.9,48156,47236,920,1.947667034
13208,2,í≤ïzés,229644,223593,6051,2.706256457,21.58,10641.5,110155,107919,2236,2.071924314
13209,2,í¨ìcés,432516,427016,5500,1.288007944,71.8,6023.9,186376,180172,6204,3.443376329
13210,2,è¨ã‡à‰és,121590,118852,2738,2.303705449,11.3,10760.2,59859,57695,2164,3.750758298
13211,2,è¨ïΩés,190245,187035,3210,1.716256316,20.51,9275.7,82994,81784,1210,1.479506994
13212,2,ì˙ñÏés,186374,180052,6322,3.511207873,27.55,6764.9,84473,80138,4335,5.409418753
13213,2,ìåë∫éRés,150130,153557,-3427,-2.231744564,17.14,8759,64578,63985,593,0.926779714
13214,2,çëï™éõés,122701,120650,2051,1.699958558,11.46,10706.9,59116,57775,1341,2.321073129
13215,2,çëóßés,73274,75510,-2236,-2.961197192,8.15,8990.7,33627,35767,-2140,-5.983168843
13218,2,ïüê∂és,58432,59796,-1364,-2.281089036,10.16,5751.2,27413,27045,368,1.360695138
13219,2,çùç]és,80074,78751,1323,1.679978667,6.39,12531.1,39520,39168,352,0.898692811
13220,2,ìåëÂòaés,85167,83068,2099,2.526845476,13.42,6346.3,35570,33648,1922,5.712077984
13221,2,ê¥ê£és,74893,74104,789,1.064719853,10.23,7320.9,32352,30954,1398,4.516379143
13222,2,ìåãvóØïƒés,116668,116546,122,0.104679697,12.88,9058.1,49904,49177,727,1.478333367
13223,2,ïêë†ë∫éRés,71268,70053,1215,1.734401096,15.32,4652,28266,26790,1476,5.509518477
13224,2,ëΩñÄés,146627,147648,-1021,-0.691509536,21.01,6978.9,65476,64078,1398,2.181716034
13225,2,àÓèÈés,87645,84835,2810,3.312312135,17.97,4877.3,36324,34842,1482,4.253487171
13227,2,âHë∫és,55845,57032,-1187,-2.081287698,9.9,5640.9,23419,23449,-30,-0.127937226
13228,2,Ç†Ç´ÇÈñÏés,80980,80868,112,0.138497304,73.47,1102.2,30734,29385,1349,4.590777608
13229,2,êºìåãûés,199823,196511,3312,1.685401835,15.75,12687.2,89676,87457,2219,2.537246876
13300,c,êºëΩñÄåS,58228,58750,-522,-0.888510638,375.86,154.9,21814,20962,852,4.064497662
13303,3,êêï‰í¨,33461,33497,-36,-0.107472311,16.85,1985.8,13160,12369,791,6.395019808
13305,3,ì˙ÇÃèoí¨,17325,16650,675,4.054054054,28.07,617.2,5773,5461,312,5.713239334
13307,3,ûwå¥ë∫,2207,2558,-351,-13.72165755,105.41,20.9,837,915,-78,-8.524590164
13308,3,âúëΩñÄí¨,5235,6045,-810,-13.39950372,225.53,23.2,2044,2217,-173,-7.803337844
13360,c,ëÂìáéxí°,12862,13574,-712,-5.245321939,140.98,91.2,6194,6340,-146,-2.302839117
13361,3,ëÂìáí¨,7883,8461,-578,-6.831343813,90.76,86.9,3951,4098,-147,-3.587115666
13362,3,óòìáë∫,338,341,-3,-0.879765396,4.12,82,194,204,-10,-4.901960784
13363,3,êVìáë∫,2750,2883,-133,-4.613250087,27.52,99.9,1258,1251,7,0.559552358
13364,3,ê_í√ìáë∫,1891,1889,2,0.105876125,18.58,101.8,791,787,4,0.508259212
13380,c,éOëÓéxí°,2817,3024,-207,-6.845238095,75.81,37.2,1677,1776,-99,-5.574324324
13381,3,éOëÓë∫,2482,2676,-194,-7.249626308,55.27,44.9,1483,1578,-95,-6.020278834
13382,3,å‰ë†ìáë∫,335,348,-13,-3.735632184,20.54,16.3,194,198,-4,-2.02020202
13400,c,î™è‰éxí°,7793,8432,-639,-7.578273245,82.99,93.9,4045,4212,-167,-3.964862298
13401,3,î™è‰í¨,7615,8231,-616,-7.483902321,72.21,105.5,3920,4090,-170,-4.156479218
13402,3,ê¬Éñìáë∫,178,201,-23,-11.44278607,5.96,29.9,125,122,3,2.459016393
13420,c,è¨ä}å¥éxí°,3023,2785,238,8.54578097,104.35,29,1517,1344,173,12.87202381
13421,3,è¨ä}å¥ë∫,3023,2785,238,8.54578097,104.35,29,1517,1344,173,12.87202381
14000,a,ê_ìﬁêÏåß,9127323,9048302,79021,0.873324078,2415.81,3778.2,3978243,3844512,133731,3.478490898
14001,b,ésïî,8834022,8743058,90964,1.040414006,1809.51,4882,3862447,3727577,134870,3.618168049
14002,b,åSïî,293301,305244,-11943,-3.912607619,606.3,483.8,115796,116935,-1139,-0.97404541
14100,1,â°ïlés,3726167,3688773,37394,1.013724618,437.49,8517.1,1645245,1583889,61356,3.873756305
14101,0,â°ïlés íﬂå©ãÊ,285404,272178,13226,4.859320004,33.23,8588.7,132833,124177,8656,6.970695056
14102,0,â°ïlés ê_ìﬁêÏãÊ,239109,233429,5680,2.433288066,23.73,10076.2,119222,113613,5609,4.936935034
14103,0,â°ïlés êºãÊ,98554,94867,3687,3.886493723,7.03,14019.1,51744,49076,2668,5.43646589
14104,0,â°ïlés íÜãÊ,148356,146033,2323,1.59073634,21.2,6997.9,78836,75700,3136,4.142668428
14105,0,â°ïlés ìÏãÊ,194927,196153,-1226,-0.625022304,12.65,15409.2,95614,92352,3262,3.532137907
14106,0,â°ïlés ï€ìyÉPíJãÊ,205560,206634,-1074,-0.519759575,21.93,9373.5,92878,90076,2802,3.110706515
14107,0,â°ïlés àÈéqãÊ,166263,163237,3026,1.853746393,19.05,8727.7,74538,71169,3369,4.733802639
14108,0,â°ïlés ã‡ëÚãÊ,202300,209274,-6974,-3.332473217,30.96,6534.2,86878,86773,105,0.121005382
14109,0,â°ïlés ç`ñkãÊ,344261,329471,14790,4.489014208,31.4,10963.7,163484,154733,8751,5.65554859
14110,0,â°ïlés åÀíÀãÊ,275349,274324,1025,0.373645762,35.79,7693.5,113347,109824,3523,3.207859849
14111,0,â°ïlés ç`ìÏãÊ,215775,221411,-5636,-2.54549232,19.9,10843,90993,90108,885,0.982154748
14112,0,â°ïlés àÆãÊ,247234,251086,-3852,-1.534135715,32.73,7553.7,102683,100980,1703,1.686472569
14113,0,â°ïlés óŒãÊ,180426,177631,2795,1.57348661,25.51,7072.8,74418,71204,3214,4.51379136
14114,0,â°ïlés ê£íJãÊ,124626,126913,-2287,-1.802021858,17.17,7258.4,50484,49560,924,1.86440678
14115,0,â°ïlés âhãÊ,122227,124866,-2639,-2.113465635,18.52,6599.7,50400,50345,55,0.109246201
14116,0,â°ïlés êÚãÊ,154038,155698,-1660,-1.066166553,23.58,6532.6,60701,58838,1863,3.166321085
14117,0,â°ïlés ê¬ótãÊ,309859,304297,5562,1.827819532,35.22,8797.8,125714,120378,5336,4.43270365
14118,0,â°ïlés ìsí}ãÊ,211899,201271,10628,5.280442786,27.87,7603.1,80478,74983,5495,7.328327754
14130,1,êÏçËés,1475300,1425512,49788,3.492639838,143,10316.8,691236,662694,28542,4.306965206
14131,0,êÏçËés êÏçËãÊ,223440,217328,6112,2.812338953,39.53,5652.4,109474,105586,3888,3.682306366
14132,0,êÏçËés çKãÊ,160864,154212,6652,4.313542396,10.01,16070.3,75139,70680,4459,6.308715337
14133,0,êÏçËés íÜå¥ãÊ,247476,233925,13551,5.792882334,14.74,16789.4,123312,117190,6122,5.223995221
14134,0,êÏçËés çÇí√ãÊ,228119,217360,10759,4.949852779,16.36,13943.7,107920,101753,6167,6.060754966
14135,0,êÏçËés ëΩñÄãÊ,214240,213894,346,0.161762368,20.5,10450.7,106390,103595,2795,2.698006661
14136,0,êÏçËés ã{ëOãÊ,225604,218867,6737,3.078125071,18.61,12122.7,94754,92164,2590,2.81020789
14137,0,êÏçËés ñÉê∂ãÊ,175557,169926,5631,3.313795417,23.25,7550.8,74247,71726,2521,3.514764521
14150,1,ëäñÕå¥és,720914,717515,3399,0.47371832,328.66,2193.5,311234,302802,8432,2.784657961
14151,0,ëäñÕå¥és óŒãÊ,173710,176192,-2482,-1.408690519,253.68,684.8,71168,70052,1116,1.593102267
14152,0,ëäñÕå¥és íÜâõãÊ,270021,266982,3039,1.138278985,36.87,7323.6,116294,112483,3811,3.38806753
14153,0,ëäñÕå¥és ìÏãÊ,277183,274341,2842,1.035937027,38.11,7273.2,123772,120267,3505,2.914348907
14201,2,â°ê{âÍés,406686,418325,-11639,-2.7822865,100.83,4033.4,165755,164362,1393,0.8475195
14203,2,ïΩíÀés,258246,260780,-2534,-0.971700284,67.82,3807.8,107339,104369,2970,2.845672566
14204,2,äôëqés,172902,174314,-1412,-0.81003247,39.66,4359.6,73032,72463,569,0.785228323
14205,2,ì°ëÚés,424103,409657,14446,3.526364739,69.57,6096.1,180180,171981,8199,4.767387095
14206,2,è¨ìcå¥és,194174,198327,-4153,-2.094016448,113.79,1706.4,79154,77793,1361,1.749514738
14207,2,äùÉñçËés,239424,235081,4343,1.847448326,35.7,6706.6,97944,93445,4499,4.814596822
14208,2,êÄéqés,56492,58302,-1810,-3.104524716,17.28,3269.2,24318,23844,474,1.98792149
14210,2,éOâYés,45302,48352,-3050,-6.30790867,32.05,1413.5,17563,17884,-321,-1.79490047
14211,2,ê`ñÏés,167387,170145,-2758,-1.620970349,103.76,1613.2,69616,69373,243,0.350280368
14212,2,å˙ñÿés,225503,224420,1083,0.48257731,93.84,2403.1,95964,92476,3488,3.771789437
14213,2,ëÂòaés,233061,228186,4875,2.13641503,27.09,8603.2,101971,97244,4727,4.860968286
14214,2,à…ê®å¥és,101575,101039,536,0.530488227,55.56,1828.2,43075,41184,1891,4.591588967
14215,2,äCòVñºés,130287,127707,2580,2.020249477,26.59,4899.8,53402,50405,2997,5.945838707
14216,2,ç¿ä‘és,128651,129436,-785,-0.606477332,17.57,7322.2,55807,53977,1830,3.39033292
14217,2,ìÏë´ïøés,43328,44020,-692,-1.572012722,77.12,561.8,16239,15873,366,2.305802306
14218,2,àªê£és,84520,83167,1353,1.626847187,22.14,3817.5,33373,31519,1854,5.882166312
14300,c,éOâYåS,32104,32766,-662,-2.020386987,17.04,1884,12551,12539,12,0.095701412
14301,3,ótéRí¨,32104,32766,-662,-2.020386987,17.04,1884,12551,12539,12,0.095701412
14320,c,çÇç¿åS,47935,47672,263,0.551686525,13.34,3593.3,18757,18033,724,4.014861643
14321,3,ä¶êÏí¨,47935,47672,263,0.551686525,13.34,3593.3,18757,18033,724,4.014861643
14340,c,íÜåS,59958,62554,-2596,-4.150014388,26.25,2284.1,23401,23754,-353,-1.486065505
14341,3,ëÂàÈí¨,31568,33032,-1464,-4.432065876,17.18,1837.5,12220,12416,-196,-1.578608247
14342,3,ìÒã{í¨,28390,29522,-1132,-3.834428562,9.08,3126.7,11181,11338,-157,-1.384723937
14360,c,ë´ïøè„åS,65625,67791,-2166,-3.195114396,303.28,216.4,23987,23825,162,0.679958027
14361,3,íÜà‰í¨,9683,10010,-327,-3.266733267,19.99,484.4,3356,3339,17,0.509134471
14362,3,ëÂà‰í¨,17036,17972,-936,-5.208101491,14.38,1184.7,6175,6350,-175,-2.755905512
14363,3,èºìcí¨,11162,11676,-514,-4.402192532,37.75,295.7,4393,4433,-40,-0.902323483
14364,3,éRñkí¨,10723,11764,-1041,-8.849030942,224.61,47.7,3882,3954,-72,-1.820940819
14366,3,äJê¨í¨,17021,16369,652,3.98313886,6.55,2598.6,6181,5749,432,7.514350322
14380,c,ë´ïøâ∫åS,44107,48913,-4806,-9.825608734,140.87,313.1,19911,21520,-1609,-7.476765799
14382,3,î†ç™í¨,11717,13853,-2136,-15.41904281,92.86,126.2,6080,7266,-1186,-16.3225984
14383,3,ê^íﬂí¨,7344,8212,-868,-10.56989771,7.04,1043.2,3066,3252,-186,-5.719557196
14384,3,ìíâÕå¥í¨,25046,26848,-1802,-6.711859356,40.97,611.3,10765,11002,-237,-2.15415379
14400,c,à§çbåS,43572,45548,-1976,-4.338280495,105.52,412.9,17189,17264,-75,-0.434430028
14401,3,à§êÏí¨,40356,42089,-1733,-4.117465371,34.28,1177.2,16065,16063,2,0.012450974
14402,3,ê¥êÏë∫,3216,3459,-243,-7.025151778,71.24,45.1,1124,1201,-77,-6.411323897
15000,a,êVäÉåß,2305098,2374450,-69352,-2.920760597,12584.1,183.2,848199,839039,9160,1.091725176
15001,b,ésïî,2225350,2290262,-64912,-2.834260884,10629.19,209.4,820687,811220,9467,1.167007717
15002,b,åSïî,79748,84188,-4440,-5.273910771,1954.91,40.8,27512,27819,-307,-1.103562314
15100,1,êVäÉés,810514,811901,-1387,-0.170833636,726.45,1115.7,321435,312533,8902,2.848339215
15101,0,êVäÉés ñkãÊ,76367,77621,-1254,-1.615542186,107.72,708.9,27072,26050,1022,3.923224568
15102,0,êVäÉés ìåãÊ,137637,138096,-459,-0.332377477,38.62,3563.9,55516,54447,1069,1.963377229
15103,0,êVäÉés íÜâõãÊ,183836,180537,3299,1.827326255,37.75,4869.8,88453,85405,3048,3.5688777
15104,0,êVäÉés ç]ìÏãÊ,68926,69365,-439,-0.632884019,75.42,913.9,23671,22963,708,3.083220834
15105,0,êVäÉés èHótãÊ,76880,77329,-449,-0.580635984,95.38,806,26910,26141,769,2.941739031
15106,0,êVäÉés ìÏãÊ,45707,46949,-1242,-2.645423758,100.91,452.9,14581,14113,468,3.316091547
15107,0,êVäÉés êºãÊ,162911,161264,1647,1.021306677,94.09,1731.4,66876,65255,1621,2.484100835
15108,0,êVäÉés êºäóãÊ,58250,60740,-2490,-4.099440237,176.55,329.9,18356,18159,197,1.084861501
15202,2,í∑â™és,275246,282674,-7428,-2.627762016,891.06,308.9,100320,98725,1595,1.615598886
15204,2,éOèés,99216,102292,-3076,-3.007077777,431.97,229.7,33179,32467,712,2.192995965
15205,2,îêçËés,86868,91451,-4583,-5.011426884,442.03,196.5,33561,34104,-543,-1.5921886
15206,2,êVî≠ìcés,98635,101202,-2567,-2.536511136,533.1,185,34081,33445,636,1.901629541
15208,2,è¨êÁíJés,36510,38600,-2090,-5.414507772,155.19,235.3,12170,12267,-97,-0.790739382
15209,2,â¡ñŒés,27864,29762,-1898,-6.377259593,133.72,208.4,9625,9677,-52,-0.537356619
15210,2,è\ì˙í¨és,54932,58911,-3979,-6.754256421,590.39,93,18591,18983,-392,-2.065005531
15211,2,å©ïçés,40620,41862,-1242,-2.966891214,77.91,521.4,13703,13371,332,2.482985566
15212,2,ë∫è„és,62463,66427,-3964,-5.967452994,1174.26,53.2,22139,22058,81,0.367213709
15213,2,âçés,79814,81876,-2062,-2.518442523,110.96,719.3,27526,26653,873,3.275428657
15216,2,éÖãõêÏés,44161,47702,-3541,-7.42316884,746.24,59.2,16711,17433,-722,-4.141570585
15217,2,ñ≠çÇés,33222,35457,-2235,-6.303409764,445.63,74.6,11597,11801,-204,-1.728667062
15218,2,å‹êÚés,51409,54550,-3141,-5.758020165,351.91,146.1,16946,16859,87,0.516044843
15222,2,è„âzés,197026,203899,-6873,-3.370786517,973.81,202.3,71016,71477,-461,-0.644962715
15223,2,à¢âÍñÏés,43421,45560,-2139,-4.694907814,192.74,225.3,13389,13154,235,1.786528813
15224,2,ç≤ìnés,57262,62727,-5465,-8.71235672,855.61,66.9,22405,23755,-1350,-5.683014102
15225,2,ãõè¿és,37370,40361,-2991,-7.410619162,946.76,39.5,12835,13075,-240,-1.835564054
15226,2,ìÏãõè¿és,58588,61624,-3036,-4.926651954,584.55,100.2,19396,19482,-86,-0.441433118
15227,2,ëŸì‡és,30209,31424,-1215,-3.866471487,264.89,114,10062,9901,161,1.626098374
15300,c,ñkäóå¥åS,14066,13724,342,2.491984844,37.58,374.3,4312,3950,362,9.164556962
15307,3,êπ‚ƒí¨,14066,13724,342,2.491984844,37.58,374.3,4312,3950,362,9.164556962
15340,c,êºäóå¥åS,8212,8582,-370,-4.311349336,25.17,326.3,2597,2586,11,0.425367363
15342,3,ñÌïFë∫,8212,8582,-370,-4.311349336,25.17,326.3,2597,2586,11,0.425367363
15360,c,ìÏäóå¥åS,12196,12791,-595,-4.651708232,31.71,384.6,4027,4027,0,0
15361,3,ìcè„í¨,12196,12791,-595,-4.651708232,31.71,384.6,4027,4027,0,0
15380,c,ìåäóå¥åS,11683,13303,-1620,-12.17770428,952.89,12.3,4484,4870,-386,-7.926078029
15385,3,à¢âÍí¨,11683,13303,-1620,-12.17770428,952.89,12.3,4484,4870,-386,-7.926078029
15400,c,éOìáåS,4529,4907,-378,-7.703281027,44.38,102.1,1608,1665,-57,-3.423423423
15405,3,èoâ_çËí¨,4529,4907,-378,-7.703281027,44.38,102.1,1608,1665,-57,-3.423423423
15460,c,ìÏãõè¿åS,8047,8396,-349,-4.156741305,357.29,22.5,3455,3463,-8,-0.231013572
15461,3,ìíëÚí¨,8047,8396,-349,-4.156741305,357.29,22.5,3455,3463,-8,-0.231013572
15480,c,íÜãõè¿åS,10034,10881,-847,-7.78421101,170.21,59,3328,3482,-154,-4.422745549
15482,3,í√ìÏí¨,10034,10881,-847,-7.78421101,170.21,59,3328,3482,-154,-4.422745549
15500,c,ä†âHåS,4776,4800,-24,-0.5,26.27,181.8,1682,1653,29,1.754385965
15504,3,ä†âHë∫,4776,4800,-24,-0.5,26.27,181.8,1682,1653,29,1.754385965
15580,c,ä‚ëDåS,6205,6804,-599,-8.803644915,309.4,20.1,2019,2123,-104,-4.898728215
15581,3,ä÷êÏë∫,5835,6438,-603,-9.366262815,299.61,19.5,1846,1941,-95,-4.894384338
15586,3,àæìáâYë∫,370,366,4,1.092896175,9.78,37.8,173,182,-9,-4.945054945
16000,a,ïxéRåß,1066883,1093247,-26364,-2.411531886,4247.61,251.2,390786,383439,7347,1.916080524
16001,b,ésïî,979033,1000016,-20983,-2.098266428,3402.6,287.7,360242,352767,7475,2.118962375
16002,b,åSïî,87850,93231,-5381,-5.771685384,845.01,104,30544,30672,-128,-0.417318727
16201,2,ïxéRés,418900,421953,-3053,-0.7235403,1241.77,337.3,163701,159151,4550,2.858920145
16202,2,çÇâ™és,172256,176061,-3805,-2.161182772,209.57,821.9,63753,61992,1761,2.840689121
16204,2,ãõí√és,42958,44959,-2001,-4.450721769,200.61,214.1,15856,15924,-68,-0.427028385
16205,2,ïXå©és,48012,51726,-3714,-7.180141515,230.56,208.2,16089,16458,-369,-2.242070726
16206,2,ääêÏés,32774,33676,-902,-2.678465376,54.63,599.9,11699,11298,401,3.549300761
16207,2,çïïîés,41022,41852,-830,-1.983178821,426.31,96.2,14793,14628,165,1.127973749
16208,2,ìvîgés,49020,49410,-390,-0.789313904,127.03,385.9,16203,15559,644,4.139083489
16209,2,è¨ñÓïîés,30416,32067,-1651,-5.148595129,134.07,226.9,9513,9581,-68,-0.709738023
16210,2,ìÏìvés,51350,54724,-3374,-6.165484979,668.64,76.8,16587,16930,-343,-2.025989368
16211,2,éÀêÖés,92325,93588,-1263,-1.349531991,109.43,843.7,32048,31246,802,2.566728541
16320,c,íÜêVêÏåS,50255,52398,-2143,-4.089850758,547.46,91.8,17408,17296,112,0.647548566
16321,3,èMã¥ë∫,2982,2967,15,0.505561173,3.47,859.4,910,889,21,2.362204724
16322,3,è„ésí¨,20940,21965,-1025,-4.66651491,236.71,88.5,7392,7415,-23,-0.310182063
16323,3,óßéRí¨,26333,27466,-1133,-4.125100124,307.29,85.7,9106,8992,114,1.267793594
16340,c,â∫êVêÏåS,37595,40833,-3238,-7.929860652,297.55,126.3,13136,13376,-240,-1.794258373
16342,3,ì¸ëPí¨,25358,27182,-1824,-6.710323008,71.25,355.9,8623,8658,-35,-0.404250404
16343,3,í©ì˙í¨,12237,13651,-1414,-10.35821552,226.3,54.1,4513,4718,-205,-4.345061467
17000,a,êŒêÏåß,1154343,1169788,-15445,-1.320324708,4186.15,275.8,453469,441170,12299,2.787814221
17001,b,ésïî,1006463,1015446,-8983,-0.884635914,3136.38,320.9,400242,387924,12318,3.175364247
17002,b,åSïî,147880,154342,-6462,-4.186805925,1049.77,140.9,53227,53246,-19,-0.035683432
17201,2,ã‡ëÚés,465810,462361,3449,0.745953919,468.64,994,199604,191256,8348,4.364830384
17202,2,éµîˆés,55348,57900,-2552,-4.407599309,318.32,173.9,20828,20944,-116,-0.553857907
17203,2,è¨èºés,106940,108433,-1493,-1.37688711,371.05,288.2,38157,37470,687,1.833466773
17204,2,ó÷ìáés,27205,29858,-2653,-8.88539085,426.32,63.8,10680,11366,-686,-6.035544607
17205,2,éÏèFés,14631,16300,-1669,-10.2392638,247.26,59.2,5867,6228,-361,-5.79640334
17206,2,â¡âÍés,67235,71887,-4652,-6.471267406,305.87,219.8,24840,25966,-1126,-4.33643996
17207,2,âHçÓés,21726,23032,-1306,-5.670371657,81.85,265.4,8066,8085,-19,-0.235003092
17209,2,Ç©ÇŸÇ≠és,34226,34651,-425,-1.226515829,64.44,531.1,11603,11084,519,4.682425117
17210,2,îíéRés,109321,110459,-1138,-1.030246517,754.93,144.8,38388,36556,1832,5.011489222
17211,2,î\î¸és,48899,48680,219,0.449876746,84.14,581.2,17380,15945,1435,8.999686422
17212,2,ñÏÅXésés,55122,51885,3237,6.23879734,13.56,4065,24829,23024,1805,7.839645587
17320,c,î\î¸åS,6360,6147,213,3.465104929,14.64,434.4,1846,1720,126,7.325581395
17324,3,êÏñkí¨,6360,6147,213,3.465104929,14.64,434.4,1846,1720,126,7.325581395
17360,c,âÕñkåS,63964,63867,97,0.151878122,130.92,488.6,23013,21960,1053,4.795081967
17361,3,í√î¶í¨,36982,36940,42,0.113697889,110.59,334.4,12552,11942,610,5.108022107
17365,3,ì‡ìÂí¨,26982,26927,55,0.204255951,20.33,1327.2,10461,10018,443,4.422040327
17380,c,âHçÓåS,33605,36493,-2888,-7.913846491,358.28,93.8,11943,12410,-467,-3.763094279
17384,3,éuâÍí¨,20434,22216,-1782,-8.021245949,246.76,82.8,7495,7849,-354,-4.510128679
17386,3,ïÛíBéuêÖí¨,13171,14277,-1106,-7.746725503,111.52,118.1,4448,4561,-113,-2.477526858
17400,c,é≠ìáåS,17582,18535,-953,-5.141623955,89.45,196.6,6053,6133,-80,-1.304418718
17407,3,íÜî\ìoí¨,17582,18535,-953,-5.141623955,89.45,196.6,6053,6133,-80,-1.304418718
17460,c,ñPéÏåS,26369,29300,-2931,-10.00341297,456.48,57.8,10372,11023,-651,-5.905833258
17461,3,åäêÖí¨,8793,9735,-942,-9.67642527,183.21,48,3464,3659,-195,-5.329324952
17463,3,î\ìoí¨,17576,19565,-1989,-10.16611296,273.27,64.3,6908,7364,-456,-6.192286801
18000,a,ïüà‰åß,787099,806314,-19215,-2.383066647,4190.43,187.8,279380,275599,3781,1.371920798
18001,b,ésïî,688140,701606,-13466,-1.919310838,2789.09,246.7,245037,241104,3933,1.631246267
18002,b,åSïî,98959,104708,-5749,-5.490506934,1401.34,70.6,34343,34495,-152,-0.440643572
18201,2,ïüà‰és,266002,266796,-794,-0.297605661,536.41,495.9,99554,97446,2108,2.163249389
18202,2,ì÷âÍés,66187,67760,-1573,-2.321428571,251.34,263.3,26530,26453,77,0.291082297
18204,2,è¨ïlés,29673,31340,-1667,-5.319081047,233.09,127.3,11238,11477,-239,-2.082425721
18205,2,ëÂñÏés,33128,35291,-2163,-6.129041399,872.43,38,10671,10847,-176,-1.622568452
18206,2,èüéRés,24144,25466,-1322,-5.191235373,253.88,95.1,7701,7773,-72,-0.926283288
18207,2,éIç]és,68337,67450,887,1.315048184,84.59,807.9,22324,21028,1296,6.163210957
18208,2,Ç†ÇÌÇÁés,28756,29989,-1233,-4.111507553,116.98,245.8,9699,9735,-36,-0.369799692
18209,2,âzëOés,81613,85614,-4001,-4.673301096,230.7,353.8,27881,27601,280,1.014455998
18210,2,ç‚à‰és,90300,91900,-1600,-1.741022851,209.67,430.7,29439,28744,695,2.417895909
18320,c,ãgìcåS,19890,20647,-757,-3.666392212,94.43,210.6,7295,7217,78,1.080781488
18322,3,âiïΩéõí¨,19890,20647,-757,-3.666392212,94.43,210.6,7295,7217,78,1.080781488
18380,c,ç°óßåS,2639,3046,-407,-13.36178595,194.65,13.6,903,1006,-103,-10.23856859
18382,3,írìcí¨,2639,3046,-407,-13.36178595,194.65,13.6,903,1006,-103,-10.23856859
18400,c,ìÏèåS,10799,11551,-752,-6.510258852,343.69,31.4,3348,3483,-135,-3.875968992
18404,3,ìÏâzëOí¨,10799,11551,-752,-6.510258852,343.69,31.4,3348,3483,-135,-3.875968992
18420,c,íOê∂åS,21527,23160,-1633,-7.050949914,153.15,140.6,6581,6728,-147,-2.18489893
18423,3,âzëOí¨,21527,23160,-1633,-7.050949914,153.15,140.6,6581,6728,-147,-2.18489893
18440,c,éOï˚åS,9919,10563,-644,-6.096752816,152.34,65.1,3915,3879,36,0.928074246
18442,3,î¸ïlí¨,9919,10563,-644,-6.096752816,152.34,65.1,3915,3879,36,0.928074246
18480,c,ëÂî—åS,18921,19642,-721,-3.670705631,284.59,66.5,7405,7188,217,3.018920423
18481,3,çÇïlí¨,10596,11062,-466,-4.212619779,72.4,146.4,4188,4044,144,3.560830861
18483,3,Ç®Ç®Ç¢í¨,8325,8580,-255,-2.972027972,212.19,39.2,3217,3144,73,2.321882952
18500,c,éOï˚è„íÜåS,15264,16099,-835,-5.186657556,178.49,85.5,4896,4994,-98,-1.962354826
18501,3,é·ã∑í¨,15264,16099,-835,-5.186657556,178.49,85.5,4896,4994,-98,-1.962354826
19000,a,éRóúåß,835165,863075,-27910,-3.233786172,4464.99,187,329953,327721,2232,0.681067127
19001,b,ésïî,713066,736930,-23864,-3.238299431,2816.42,253.2,283192,281653,1539,0.546417045
19002,b,åSïî,122099,126145,-4046,-3.207420033,1648.56,74.1,46761,46068,693,1.504297994
19201,2,çbï{és,193123,198992,-5869,-2.949364799,212.47,908.9,84522,85101,-579,-0.680368033
19202,2,ïxémãgìcés,49024,50619,-1595,-3.150990735,121.74,402.7,18082,17713,369,2.083215717
19204,2,ìsóØés,32014,33588,-1574,-4.686197452,161.63,198.1,13440,13536,-96,-0.709219858
19205,2,éRóúés,35155,36832,-1677,-4.553105995,289.8,121.3,12890,13039,-149,-1.142725669
19206,2,ëÂåéés,25437,28120,-2683,-9.541251778,280.25,90.8,9733,10151,-418,-4.117820904
19207,2,îBçËés,30672,32477,-1805,-5.557779352,143.69,213.5,11600,11826,-226,-1.911043464
19208,2,ìÏÉAÉãÉvÉXés,70843,72635,-1792,-2.467130171,264.14,268.2,24979,24500,479,1.955102041
19209,2,ñkìmés,45116,46968,-1852,-3.943110203,602.48,74.9,18407,18281,126,0.689240195
19210,2,çbî„és,74417,73807,610,0.826479873,71.95,1034.3,29441,28207,1234,4.374800581
19211,2,ìJêÅés,69600,70529,-929,-1.317188674,201.92,344.7,26259,25500,759,2.976470588
19212,2,è„ñÏå¥és,24812,27114,-2302,-8.490078926,170.57,145.5,9632,10032,-400,-3.987240829
19213,2,çbèBés,31714,33927,-2213,-6.522828426,264.11,120.1,11409,11588,-179,-1.544701415
19214,2,íÜâõés,31139,31322,-183,-0.584253879,31.69,982.6,12798,12179,619,5.08251909
19340,c,êºî™ë„åS,15663,17111,-1448,-8.462392613,75.18,208.3,5881,6074,-193,-3.177477774
19346,3,ésêÏéOãΩí¨,15663,17111,-1448,-8.462392613,75.18,208.3,5881,6074,-193,-3.177477774
19360,c,ìÏãêñÄåS,37104,41026,-3922,-9.559791352,984.82,37.7,14446,15131,-685,-4.527129734
19364,3,ëÅêÏí¨,1070,1246,-176,-14.12520064,369.96,2.9,573,681,-108,-15.85903084
19365,3,êgâÑí¨,12673,14462,-1789,-12.37034988,301.98,42,5198,5593,-395,-7.062399428
19366,3,ìÏïîí¨,8071,9011,-940,-10.4316946,200.87,40.2,3002,3088,-86,-2.784974093
19368,3,ïxémêÏí¨,15290,16307,-1017,-6.236585515,112,136.5,5673,5769,-96,-1.664066563
19380,c,íÜãêñÄåS,19507,17653,1854,10.50246417,9.08,2148.3,8207,7162,1045,14.5908964
19384,3,è∫òaí¨,19507,17653,1854,10.50246417,9.08,2148.3,8207,7162,1045,14.5908964
19420,c,ìÏìsóØåS,48534,48854,-320,-0.655012896,420.71,115.4,17597,17020,577,3.39012926
19422,3,ìπéuë∫,1743,1919,-176,-9.17144346,79.68,21.9,590,588,2,0.340136054
19423,3,êºåjí¨,4345,4541,-196,-4.316229905,15.22,285.5,1472,1443,29,2.00970201
19424,3,îEñÏë∫,8974,8635,339,3.925883034,25.05,358.2,3035,2802,233,8.315488937
19425,3,éRíÜåŒë∫,5210,5324,-114,-2.141247183,52.77,98.7,1867,1763,104,5.899035735
19429,3,ñ¬ëÚë∫,2921,2964,-43,-1.45074224,89.58,32.6,1033,1015,18,1.773399015
19430,3,ïxémâÕå˚åŒí¨,25341,25471,-130,-0.510384359,158.4,160,9600,9409,191,2.029971304
19440,c,ñkìsóØåS,1291,1501,-210,-13.99067288,154.08,8.4,630,681,-51,-7.488986784
19442,3,è¨êõë∫,726,816,-90,-11.02941176,52.78,13.8,337,347,-10,-2.88184438
19443,3,íOîgéRë∫,565,685,-120,-17.51824818,101.3,5.6,293,334,-41,-12.2754491
20000,a,í∑ñÏåß,2099759,2152449,-52690,-2.447909335,13561.56,154.8,806447,794461,11986,1.508695833
20001,b,ésïî,1676096,1707312,-31216,-1.828371147,6724.04,249.3,651578,639103,12475,1.951954536
20002,b,åSïî,423663,445137,-21474,-4.824132795,6837.52,62,154869,155358,-489,-0.314756884
20201,2,í∑ñÏés,377803,381511,-3708,-0.971924794,834.81,452.6,150465,146520,3945,2.692465193
20202,2,èºñ{és,243383,243037,346,0.142365154,978.47,248.7,100081,97303,2778,2.854999332
20203,2,è„ìcés,156909,159597,-2688,-1.684242185,552.04,284.2,62606,60660,1946,3.20804484
20204,2,â™íJés,50146,52841,-2695,-5.100206279,85.1,589.3,18950,19501,-551,-2.825496128
20205,2,î—ìcés,101676,105335,-3659,-3.473679214,658.66,154.4,37570,37867,-297,-0.784324082
20206,2,êzñKés,50163,51200,-1037,-2.025390625,109.17,459.5,20367,20444,-77,-0.376638623
20207,2,ê{ç‚és,50743,52168,-1425,-2.731559577,149.67,339,18453,18106,347,1.916491771
20208,2,è¨èîés,42536,43997,-1461,-3.320680956,98.55,431.6,16624,16343,281,1.719390565
20209,2,à…ìﬂés,68322,71093,-2771,-3.897711448,667.93,102.3,26263,26112,151,0.578278186
20210,2,ãÓÉñç™és,32768,33693,-925,-2.745377378,165.86,197.6,12417,12161,256,2.105090042
20211,2,íÜñÏés,43900,45638,-1738,-3.808229984,112.18,391.3,15275,15092,183,1.212562947
20212,2,ëÂí¨és,28045,29801,-1756,-5.892419718,565.15,49.6,10822,11054,-232,-2.098787769
20213,2,î—éRés,21444,23545,-2101,-8.923338288,202.43,105.9,7374,7694,-320,-4.159085001
20214,2,äùñÏés,55951,56391,-440,-0.780266355,266.59,209.9,22324,21687,637,2.93724351
20215,2,âñêKés,67170,67670,-500,-0.738879858,289.98,231.6,26245,25092,1153,4.595090069
20217,2,ç≤ãvés,99416,100552,-1136,-1.129763704,423.51,234.7,38487,37032,1455,3.929034349
20218,2,êÁã»és,60317,62068,-1751,-2.821099439,119.79,503.5,21554,21449,105,0.489533312
20219,2,ìåå‰és,30107,30696,-589,-1.918816784,112.37,267.9,11007,10801,206,1.907230812
20220,2,à¿ì‹ñÏés,95297,96479,-1182,-1.225137077,331.78,287.2,34694,34185,509,1.488957145
20300,c,ìÏç≤ãvåS,25700,27712,-2012,-7.26039261,767.43,33.5,8890,9040,-150,-1.659292035
20303,3,è¨äCí¨,4716,5180,-464,-8.957528958,114.2,41.3,1869,1843,26,1.410743353
20304,3,êÏè„ë∫,4603,4972,-369,-7.42156074,209.61,22,1202,1336,-134,-10.02994012
20305,3,ìÏñqë∫,3409,3528,-119,-3.373015873,133.09,25.6,1023,1005,18,1.791044776
20306,3,ìÏëäñÿë∫,1005,1121,-116,-10.34790366,66.05,15.2,420,433,-13,-3.002309469
20307,3,ñkëäñÿë∫,775,842,-67,-7.957244656,56.32,13.8,359,331,28,8.459214502
20309,3,ç≤ãvï‰í¨,11192,12069,-877,-7.266550667,188.15,59.5,4017,4092,-75,-1.832844575
20320,c,ñkç≤ãvåS,41473,41463,10,0.024117888,281.69,147.2,17024,16377,647,3.950662515
20321,3,åyà‰ëÚí¨,19005,19018,-13,-0.068356294,156.03,121.8,8228,8082,146,1.806483544
20323,3,å‰ë„ìcí¨,15197,14738,459,3.114398154,58.79,258.5,6112,5623,489,8.696425396
20324,3,óßâ»í¨,7271,7707,-436,-5.657194758,66.87,108.7,2684,2672,12,0.449101796
20340,c,è¨åßåS,10515,11389,-874,-7.674071473,240.96,43.6,3971,4031,-60,-1.488464401
20349,3,ê¬ñÿë∫,4345,4609,-264,-5.727923628,57.1,76.1,1557,1563,-6,-0.383877159
20350,3,í∑òaí¨,6170,6780,-610,-8.997050148,183.86,33.6,2414,2468,-54,-2.188006483
20360,c,êzñKåS,42300,44443,-2143,-4.821906712,254.89,166,15989,16563,-574,-3.465555757
20361,3,â∫êzñKí¨,20236,21532,-1296,-6.018948542,66.87,302.6,7922,8361,-439,-5.250568114
20362,3,ïxémå©í¨,14494,15338,-844,-5.5026731,144.76,100.1,5395,5634,-239,-4.242101526
20363,3,å¥ë∫,7570,7573,-3,-0.03961442,43.26,175,2672,2568,104,4.049844237
20380,c,è„à…ìﬂåS,83310,85616,-2306,-2.69342179,514.61,161.9,30431,29938,493,1.646736589
20382,3,íCñÏí¨,19785,20909,-1124,-5.375675546,169.2,116.9,7340,7356,-16,-0.217509516
20383,3,ñ•ó÷í¨,25237,26214,-977,-3.727016098,85.91,293.8,9239,9112,127,1.393766462
20384,3,î—ìáí¨,9546,9902,-356,-3.595233286,86.96,109.8,3317,3242,75,2.313386798
20385,3,ìÏñ•ó÷ë∫,15070,14543,527,3.623736506,40.99,367.7,5834,5560,274,4.928057554
20386,3,íÜêÏë∫,4851,5074,-223,-4.394954671,77.05,63,1574,1576,-2,-0.126903553
20388,3,ã{ìcë∫,8821,8974,-153,-1.70492534,54.5,161.9,3127,3092,35,1.131953428
20400,c,â∫à…ìﬂåS,60649,64169,-3520,-5.485514812,1270.23,47.7,20476,20677,-201,-0.972094598
20402,3,èºêÏí¨,13183,13676,-493,-3.604855221,72.79,181.1,4361,4287,74,1.726148822
20403,3,çÇêXí¨,13084,13216,-132,-0.998789346,45.36,288.4,4244,4157,87,2.092855425
20404,3,à¢ìÏí¨,4963,5455,-492,-9.019248396,123.07,40.3,1736,1793,-57,-3.179029559
20407,3,à¢íqë∫,6540,7036,-496,-7.04945992,214.43,30.5,2191,2301,-110,-4.780530204
20409,3,ïΩíJë∫,485,563,-78,-13.85435169,77.37,6.3,229,229,0,0
20410,3,ç™âHë∫,970,1129,-159,-14.08325952,89.97,10.8,434,450,-16,-3.555555556
20411,3,â∫ûäë∫,3856,4200,-344,-8.190476191,38.12,101.2,1154,1189,-35,-2.943650126
20412,3,îÑñÿë∫,575,656,-81,-12.34756098,43.43,13.2,270,288,-18,-6.25
20413,3,ìVó¥ë∫,1363,1657,-294,-17.74290887,109.44,12.5,659,737,-78,-10.5834464
20414,3,ë◊ïåë∫,1702,1910,-208,-10.89005236,64.59,26.4,641,657,-16,-2.435312024
20415,3,ã™ñÿë∫,6310,6692,-382,-5.708308428,66.61,94.7,2029,2058,-29,-1.409135083
20416,3,ñLãuë∫,6594,6819,-225,-3.299604048,76.79,85.9,2053,2000,53,2.65
20417,3,ëÂé≠ë∫,1024,1160,-136,-11.72413793,248.28,4.1,475,531,-56,-10.54613936
20420,c,ñÿë]åS,28421,31042,-2621,-8.443399266,1546.15,18.4,11475,11949,-474,-3.966859151
20422,3,è„èºí¨,4673,5245,-572,-10.9056244,168.42,27.7,1867,2029,-162,-7.984228684
20423,3,ìÏñÿë]í¨,4317,4810,-493,-10.24948025,215.93,20,1714,1830,-116,-6.338797814
20425,3,ñÿëcë∫,2926,3134,-208,-6.636885769,140.5,20.8,1045,1069,-24,-2.245088868
20429,3,â§ëÍë∫,839,965,-126,-13.05699482,310.82,2.7,399,414,-15,-3.623188406
20430,3,ëÂåKë∫,3832,4145,-313,-7.551266586,234.47,16.3,1516,1537,-21,-1.366297983
20432,3,ñÿë]í¨,11834,12743,-909,-7.133328102,476.03,24.9,4934,5070,-136,-2.682445759
20440,c,ìåí}ñÄåS,22238,23261,-1023,-4.397919264,268.51,82.8,7667,7605,62,0.815253123
20446,3,ñÉê—ë∫,2791,2970,-179,-6.026936027,34.38,81.2,1024,1011,13,1.285855589
20448,3,ê∂ç‚ë∫,1844,1953,-109,-5.581157194,39.05,47.2,698,732,-34,-4.644808743
20450,3,éRå`ë∫,8403,8425,-22,-0.261127596,24.98,336.4,2752,2601,151,5.805459439
20451,3,í©ì˙ë∫,4467,4741,-274,-5.779371441,70.62,63.3,1411,1422,-11,-0.773558369
20452,3,í}ñkë∫,4733,5172,-439,-8.488012374,99.47,47.6,1782,1839,-57,-3.099510604
20480,c,ñkà¿ì‹åS,31724,32848,-1124,-3.421821724,544.5,58.3,11651,11391,260,2.282503731
20481,3,írìcí¨,9930,10329,-399,-3.862910253,40.16,247.3,3517,3510,7,0.199430199
20482,3,èºêÏë∫,9950,10093,-143,-1.416823541,47.07,211.4,3496,3386,110,3.248670998
20485,3,îíînë∫,8937,9205,-268,-2.911461162,189.36,47.2,3471,3245,226,6.964560863
20486,3,è¨íJë∫,2907,3221,-314,-9.748525303,267.91,10.9,1167,1250,-83,-6.64
20520,c,è˚â»åS,14866,15730,-864,-5.492689129,53.64,277.1,5479,5505,-26,-0.472297911
20521,3,ç‚èÈí¨,14866,15730,-864,-5.492689129,53.64,277.1,5479,5505,-26,-0.472297911
20540,c,è„çÇà‰åS,17733,18635,-902,-4.840354172,117.68,150.7,5822,5799,23,0.396620107
20541,3,è¨ïzé{í¨,10704,11072,-368,-3.323699422,19.12,559.8,3531,3511,20,0.56963828
20543,3,çÇéRë∫,7029,7563,-534,-7.060690202,98.56,71.3,2291,2288,3,0.131118881
20560,c,â∫çÇà‰åS,20572,22470,-1898,-8.44681798,423.18,48.6,7184,7447,-263,-3.531623473
20561,3,éRÉmì‡í¨,12437,13678,-1241,-9.072963884,265.9,46.8,4463,4666,-203,-4.350621517
20562,3,ñÿìáïΩë∫,4661,4939,-278,-5.628669771,99.32,46.9,1564,1560,4,0.256410256
20563,3,ñÏëÚâ∑êÚë∫,3474,3853,-379,-9.836491046,57.96,59.9,1157,1221,-64,-5.241605242
20580,c,è„êÖì‡åS,22210,24144,-1934,-8.010271703,282.41,78.6,8035,8187,-152,-1.85660193
20583,3,êMîZí¨,8474,9238,-764,-8.270188353,149.3,56.8,3170,3247,-77,-2.371419772
20588,3,è¨êÏë∫,2671,3041,-370,-12.16705031,58.11,46,1095,1152,-57,-4.947916667
20590,3,î—çjí¨,11065,11865,-800,-6.742520017,75,147.5,3770,3788,-18,-0.475184794
20600,c,â∫êÖì‡åS,1952,2215,-263,-11.87358916,271.66,7.2,775,849,-74,-8.716136631
20602,3,âhë∫,1952,2215,-263,-11.87358916,271.66,7.2,775,849,-74,-8.716136631
21000,a,äÚïååß,2032533,2080773,-48240,-2.318369183,10621.29,191.4,752574,737151,15423,2.09224433
21001,b,ésïî,1720341,1756245,-35904,-2.044361692,8455.13,203.5,644749,630031,14718,2.336075526
21002,b,åSïî,312192,324528,-12336,-3.801212838,2166.16,144.1,107825,107120,705,0.658140403
21201,2,äÚïåés,406866,413136,-6270,-1.517660044,203.6,1998.4,165128,161718,3410,2.108608813
21202,2,ëÂä_és,159927,161160,-1233,-0.765078183,206.57,774.2,60026,58536,1490,2.545442121
21203,2,çÇéRés,89205,92747,-3542,-3.81899145,2177.61,41,32680,32213,467,1.449725266
21204,2,ëΩé°å©és,110465,112595,-2130,-1.891735868,91.25,1210.6,41435,40200,1235,3.072139304
21205,2,ä÷és,89176,91418,-2242,-2.452471067,472.33,188.8,32815,32212,603,1.871973178
21206,2,íÜí√êÏés,78920,80910,-1990,-2.459522927,676.45,116.7,28426,27885,541,1.940111171
21207,2,î¸îZés,20767,22629,-1862,-8.228379513,117.01,177.5,7508,7743,-235,-3.034999354
21208,2,êêòQés,38746,40387,-1641,-4.06318865,174.86,221.6,13890,13597,293,2.154887108
21209,2,âHìáés,67357,67197,160,0.238105868,53.66,1255.3,23949,22707,1242,5.469678954
21210,2,åbìﬂés,51088,53718,-2630,-4.895938047,504.24,101.3,18088,18140,-52,-0.286659316
21211,2,î¸îZâ¡ñŒés,55414,54729,685,1.251621627,74.81,740.7,20483,19801,682,3.444270491
21212,2,ìyäÚés,57842,60475,-2633,-4.353865234,116.02,498.6,21018,20760,258,1.242774567
21213,2,äeñ±å¥és,144734,145604,-870,-0.597511057,87.81,1648.3,53421,51961,1460,2.809799657
21214,2,â¬éôés,98731,97436,1295,1.329077548,87.57,1127.5,37151,34768,2383,6.854003682
21215,2,éRåßés,27118,29629,-2511,-8.47480509,221.98,122.2,9633,9731,-98,-1.007090741
21216,2,êêï‰és,54364,51950,2414,4.646775746,28.19,1928.5,21004,19376,1628,8.402146986
21217,2,îÚëÀés,24708,26732,-2024,-7.571449948,792.53,31.2,8510,8770,-260,-2.964652224
21218,2,ñ{ëÉés,34010,35047,-1037,-2.958883785,374.65,90.8,11346,11150,196,1.757847534
21219,2,åSè„és,42094,44491,-2397,-5.387606482,1030.75,40.8,14593,14622,-29,-0.198331282
21220,2,â∫òCés,33596,36314,-2718,-7.484716638,851.21,39.5,12130,12496,-366,-2.92893726
21221,2,äCí√és,35213,37941,-2728,-7.190110962,112.03,314.3,11515,11645,-130,-1.116358952
21300,c,âHìáåS,47379,46613,766,1.643318388,18.21,2601.8,17728,16811,917,5.454761763
21302,3,äÚìÏí¨,24625,23804,821,3.449000168,7.91,3113.1,9539,8971,568,6.331512652
21303,3,ä}èºí¨,22754,22809,-55,-0.241132886,10.3,2209.1,8189,7840,349,4.451530612
21340,c,ó{òVåS,29036,31332,-2296,-7.327971403,72.29,401.7,9370,9536,-166,-1.740771812
21341,3,ó{òVí¨,29036,31332,-2296,-7.327971403,72.29,401.7,9370,9536,-166,-1.740771812
21360,c,ïsîjåS,34985,36601,-1616,-4.415179913,106.36,328.9,11986,11965,21,0.17551191
21361,3,êÇà‰í¨,27564,28505,-941,-3.301175232,57.09,482.8,9361,9245,116,1.254732288
21362,3,ä÷ÉPå¥í¨,7421,8096,-675,-8.337450593,49.28,150.6,2625,2720,-95,-3.492647059
21380,c,à¿î™åS,44017,45364,-1347,-2.969314875,59.26,742.8,14421,14428,-7,-0.048516773
21381,3,ê_åÀí¨,19286,20065,-779,-3.882382258,18.78,1026.9,6572,6511,61,0.936876056
21382,3,ó÷îVì‡í¨,9976,10028,-52,-0.518548065,22.33,446.8,3137,3015,122,4.046434494
21383,3,à¿î™í¨,14755,15271,-516,-3.378953572,18.16,812.5,4712,4902,-190,-3.875968992
21400,c,óKî„åS,69338,72623,-3285,-4.523360368,876.43,79.1,22534,22774,-240,-1.053833319
21401,3,óKî„êÏí¨,21513,23784,-2271,-9.548435923,803.44,26.8,7293,7742,-449,-5.799535004
21403,3,ëÂñÏí¨,23464,23859,-395,-1.655559747,34.2,686.1,7369,7231,138,1.90844973
21404,3,írìcí¨,24361,24980,-619,-2.477982386,38.8,627.9,7872,7801,71,0.910139726
21420,c,ñ{ëÉåS,18172,18395,-223,-1.212285947,5.18,3508.1,7106,6925,181,2.613718412
21421,3,ñkï˚í¨,18172,18395,-223,-1.212285947,5.18,3508.1,7106,6925,181,2.613718412
21500,c,â¡ñŒåS,49536,53043,-3507,-6.61161699,615.1,80.5,17597,17747,-150,-0.845213276
21501,3,ç‚èjí¨,8206,8361,-155,-1.853845234,12.87,637.6,3107,3083,24,0.778462537
21502,3,ïxâ¡í¨,5566,5516,50,0.906453952,16.82,330.9,1833,1741,92,5.284319357
21503,3,êÏï”í¨,10200,10593,-393,-3.709997168,41.16,247.8,3559,3507,52,1.482748788
21504,3,éµè@í¨,3879,4484,-605,-13.49241748,90.47,42.9,1381,1457,-76,-5.216197666
21505,3,î™ïSí√í¨,11029,12045,-1016,-8.435035284,128.79,85.6,3893,3999,-106,-2.650662666
21506,3,îíêÏí¨,8395,9530,-1135,-11.90975866,237.9,35.3,3009,3123,-114,-3.650336215
21507,3,ìåîíêÏë∫,2261,2514,-253,-10.0636436,87.09,26,815,837,-22,-2.628434887
21520,c,â¬éôåS,18119,18824,-705,-3.74521887,56.69,319.6,6530,6333,197,3.110690036
21521,3,å‰êìí¨,18119,18824,-705,-3.74521887,56.69,319.6,6530,6333,197,3.110690036
21600,c,ëÂñÏåS,1610,1733,-123,-7.097518754,356.64,4.5,553,601,-48,-7.986688852
21604,3,îíêÏë∫,1610,1733,-123,-7.097518754,356.64,4.5,553,601,-48,-7.986688852
22000,a,ê√â™åß,3701181,3765007,-63826,-1.695242532,7778.7,475.8,1427077,1399140,27937,1.996726561
22001,b,ésïî,3471202,3526718,-55516,-1.574154781,6410.72,541.5,1339862,1311751,28111,2.143013423
22002,b,åSïî,229979,238289,-8310,-3.487361985,1367.98,168.1,87215,87389,-174,-0.199109728
22100,1,ê√â™és,705238,716197,-10959,-1.530165583,1411.9,499.5,285655,279019,6636,2.378332658
22101,0,ê√â™és à®ãÊ,253677,255375,-1698,-0.664904552,1073.76,236.3,101541,98767,2774,2.808630413
22102,0,ê√â™és èxâÕãÊ,212490,213059,-569,-0.267062175,73.05,2908.8,90533,87433,3100,3.545572038
22103,0,ê√â™és ê¥êÖãÊ,239071,247763,-8692,-3.508191296,265.09,901.8,93581,92819,762,0.820952607
22130,1,ïlèºés,798252,800866,-2614,-0.326396676,1558.06,512.3,309100,300444,8656,2.881069351
22131,0,ïlèºés íÜãÊ,237479,238477,-998,-0.418488995,44.34,5355.9,106041,103707,2334,2.250571321
22132,0,ïlèºés ìåãÊ,128599,126609,1990,1.5717682,46.29,2778.1,50105,47647,2458,5.158771801
22133,0,ïlèºés êºãÊ,111400,113654,-2254,-1.983212206,114.71,971.1,38746,38359,387,1.0088897
22134,0,ïlèºés ìÏãÊ,100911,102381,-1470,-1.435813286,46.84,2154.4,38237,37517,720,1.919129994
22135,0,ïlèºés ñkãÊ,93624,94680,-1056,-1.115335868,295.54,316.8,32061,31430,631,2.007636017
22136,0,ïlèºés ïlñkãÊ,95938,91108,4830,5.301400536,66.5,1442.7,32486,29695,2791,9.398888702
22137,0,ïlèºés ìVó≥ãÊ,30301,33957,-3656,-10.76655771,943.84,32.1,11424,12089,-665,-5.500868558
22203,2,è¿í√és,195642,202304,-6662,-3.293063904,186.96,1046.4,80659,79616,1043,1.310038183
22205,2,îMäCés,37570,39611,-2041,-5.152609124,61.78,608.1,18879,19740,-861,-4.361702128
22206,2,éOìáés,110030,111838,-1808,-1.616624046,62.02,1774.1,45148,44620,528,1.183325863
22207,2,ïxémã{és,130789,132001,-1212,-0.918174862,389.08,336.1,48941,46988,1953,4.156380352
22208,2,à…ìåés,68325,71437,-3112,-4.356285958,124.1,550.6,30413,30636,-223,-0.727901815
22209,2,ìáìcés,98136,100276,-2140,-2.134109857,315.7,310.9,34108,33280,828,2.487980769
22210,2,ïxémés,248381,254027,-5646,-2.222598385,244.95,1014,92523,90980,1543,1.695977138
22211,2,î÷ìcés,167260,168625,-1365,-0.80948851,163.45,1023.3,61257,59414,1843,3.1019625
22212,2,èƒí√és,139513,143249,-3736,-2.60804613,70.31,1984.3,50156,49299,857,1.738371975
22213,2,ä|êÏés,114683,116363,-1680,-1.443757896,265.69,431.6,41040,39497,1543,3.90662582
22214,2,ì°é}és,143658,142151,1507,1.060140273,194.06,740.3,51712,49658,2054,4.136292239
22215,2,å‰ìaèÍés,88084,89030,-946,-1.062563181,194.9,451.9,31570,31403,167,0.531796325
22216,2,ë‹à‰és,85785,84846,939,1.106710982,108.33,791.9,31430,29791,1639,5.501661576
22219,2,â∫ìcés,22926,25013,-2087,-8.343661296,104.71,218.9,10376,10794,-418,-3.872521771
22220,2,êûñÏés,52737,54546,-1809,-3.316466835,138.12,381.8,20772,21042,-270,-1.28314799
22221,2,åŒêºés,59817,60107,-290,-0.482472923,86.56,691,22408,21619,789,3.64956751
22222,2,à…ì§és,31335,34202,-2867,-8.382550728,363.97,86.1,12134,12583,-449,-3.568306445
22223,2,å‰ëOçËés,32572,34700,-2128,-6.132564842,65.56,496.8,11328,11494,-166,-1.444231773
22224,2,ãeêÏés,46770,47041,-271,-0.576093195,94.19,496.5,16213,15485,728,4.701323862
22225,2,à…ì§ÇÃçëés,48152,49269,-1117,-2.26714567,94.62,508.9,18651,18742,-91,-0.485540497
22226,2,ñqîVå¥és,45547,49019,-3472,-7.082967829,111.69,407.8,15389,15607,-218,-1.396809124
22300,c,âÍñŒåS,43516,48700,-5184,-10.64476386,479.84,90.7,18510,19775,-1265,-6.396965866
22301,3,ìåà…ì§í¨,12627,14064,-1437,-10.21757679,77.86,162.2,5636,5988,-352,-5.878423514
22302,3,âÕí√í¨,7307,7998,-691,-8.639659915,100.74,72.5,2908,3029,-121,-3.994717729
22304,3,ìÏà…ì§í¨,8511,9516,-1005,-10.56116015,110.49,77,3464,3710,-246,-6.630727763
22305,3,èºçËí¨,6837,7653,-816,-10.6624853,85.21,80.2,2832,3018,-186,-6.163021869
22306,3,êºà…ì§í¨,8234,9469,-1235,-13.04255993,105.54,78,3670,4030,-360,-8.933002481
22320,c,ìcï˚åS,37657,38571,-914,-2.369655959,65.16,577.9,14281,13993,288,2.058171943
22325,3,îüìÏí¨,37657,38571,-914,-2.369655959,65.16,577.9,14281,13993,288,2.058171943
22340,c,èxìååS,93955,93694,261,0.278566397,171.46,548,35206,34256,950,2.773236805
22341,3,ê¥êÖí¨,32118,32302,-184,-0.569624172,8.81,3645.6,12355,12180,175,1.436781609
22342,3,í∑êÚí¨,42321,40763,1558,3.822093565,26.63,1589.2,16417,15512,905,5.834192883
22344,3,è¨éRí¨,19516,20629,-1113,-5.395317272,136.02,143.5,6434,6564,-130,-1.980499695
22420,c,êYå¥åS,36311,37889,-1578,-4.164797171,517.61,70.2,13087,13239,-152,-1.14812297
22424,3,ãgìcí¨,29113,29815,-702,-2.354519537,20.73,1404.4,10212,10253,-41,-0.399882961
22429,3,êÏç™ñ{í¨,7198,8074,-876,-10.84964082,496.88,14.5,2875,2986,-111,-3.717347622
22460,c,é¸íqåS,18540,19435,-895,-4.605093903,133.91,138.5,6131,6126,5,0.081619328
22461,3,êXí¨,18540,19435,-895,-4.605093903,133.91,138.5,6131,6126,5,0.081619328
23000,a,à§ímåß,7484094,7410719,73375,0.990119852,5172.4,1446.9,3060881,2933802,127079,4.331546573
23001,b,ésïî,7085440,7015162,70278,1.001801527,4305.38,1645.7,2910905,2789986,120919,4.334036085
23002,b,åSïî,398654,395557,3097,0.782946579,864.45,461.2,149976,143816,6160,4.283250821
23100,1,ñºå√âÆés,2296014,2263894,32120,1.418794343,326.44,7033.5,1057936,1021227,36709,3.594597479
23101,0,ñºå√âÆés êÁéÌãÊ,164499,160015,4484,2.80223729,18.18,9048.3,85099,80411,4688,5.830048128
23102,0,ñºå√âÆés ìåãÊ,78079,73272,4807,6.560486953,7.71,10127,41279,38562,2717,7.04579638
23103,0,ñºå√âÆés ñkãÊ,163585,165785,-2200,-1.327019936,17.53,9331.7,75340,74641,699,0.93648263
23104,0,ñºå√âÆés êºãÊ,149149,144995,4154,2.864926377,17.93,8318.4,69929,66133,3796,5.739948286
23105,0,ñºå√âÆés íÜë∫ãÊ,133275,136164,-2889,-2.121706178,16.3,8176.4,66040,68877,-2837,-4.118936655
23106,0,ñºå√âÆés íÜãÊ,83210,78353,4857,6.19886922,9.38,8871,53430,50000,3430,6.86
23107,0,ñºå√âÆés è∫òaãÊ,107200,105536,1664,1.57671316,10.94,9798.9,55234,53782,1452,2.699788033
23108,0,ñºå√âÆés êêï‰ãÊ,105384,105061,323,0.307440439,11.22,9392.5,48707,47826,881,1.842094258
23109,0,ñºå√âÆés îMìcãÊ,65903,64719,1184,1.829447303,8.2,8037,31819,30098,1721,5.717987906
23110,0,ñºå√âÆés íÜêÏãÊ,220301,221521,-1220,-0.550737853,32.02,6880.1,95271,92639,2632,2.841136023
23111,0,ñºå√âÆés ç`ãÊ,146789,149215,-2426,-1.625841906,45.63,3216.9,61540,59274,2266,3.822924048
23112,0,ñºå√âÆés ìÏãÊ,136992,141310,-4318,-3.055693157,18.46,7421,61208,61757,-549,-0.888968052
23113,0,ñºå√âÆés éÁéRãÊ,172899,168551,4348,2.579634651,34.01,5083.8,69616,67087,2529,3.769731841
23114,0,ñºå√âÆés óŒãÊ,241898,229592,12306,5.359942855,37.91,6380.8,95179,87672,7507,8.562596952
23115,0,ñºå√âÆés ñºìåãÊ,164119,161012,3107,1.929669838,19.45,8438,73925,71894,2031,2.82499235
23116,0,ñºå√âÆés ìVîíãÊ,162732,158793,3939,2.480587935,21.58,7540.9,74320,70574,3746,5.307903761
23201,2,ñLã¥és,374883,376665,-1782,-0.473099439,261.86,1431.6,144040,141424,2616,1.84975676
23202,2,â™çËés,381031,372357,8674,2.329484876,387.2,984.1,147267,138255,9012,6.518389932
23203,2,àÍã{és,379954,378566,1388,0.366646767,113.82,3338.2,142312,135837,6475,4.766742493
23204,2,ê£åÀés,129125,132224,-3099,-2.34375,111.4,1159.1,50295,50289,6,0.011931039
23205,2,îºìcés,116936,118828,-1892,-1.592217323,47.42,2466,46223,44869,1354,3.017673672
23206,2,ètì˙à‰és,306599,305569,1030,0.337076078,92.78,3304.6,124202,119187,5015,4.207673656
23207,2,ñLêÏés,182530,181928,602,0.330900136,161.14,1132.7,67889,64904,2985,4.59910021
23208,2,í√ìáés,63471,65258,-1787,-2.73836158,25.09,2529.7,23828,23509,319,1.356927134
23209,2,ï…ìÏés,71362,72018,-656,-0.91088339,37.17,1919.9,26442,25265,1177,4.658618642
23210,2,ä†íJés,149810,145781,4029,2.763734643,50.39,2973,62416,58917,3499,5.938863147
23211,2,ñLìcés,422780,421487,1293,0.306771027,918.32,460.4,169488,162065,7423,4.580261006
23212,2,à¿èÈés,184163,178691,5472,3.062269504,86.05,2140.2,70718,66707,4011,6.012862218
23213,2,êºîˆés,168045,165298,2747,1.661847088,161.22,1042.3,58882,54435,4447,8.16937632
23214,2,äóåSés,81150,82249,-1099,-1.336186458,56.89,1426.4,29903,28864,1039,3.59963969
23215,2,å¢éRés,74319,75198,-879,-1.168914067,74.9,992.2,28200,27359,841,3.073942761
23216,2,èÌääés,56560,54858,1702,3.102555689,55.89,1012,22492,20769,1723,8.296018104
23217,2,ç]ìÏés,98359,99730,-1371,-1.374711722,30.2,3256.9,37101,35768,1333,3.726794901
23219,2,è¨ñqés,149540,147132,2408,1.636625615,62.81,2380.8,59242,55783,3459,6.200813868
23220,2,àÓëÚés,136969,136358,611,0.448085188,79.35,1726.1,49864,47500,2364,4.976842105
23221,2,êVèÈés,47150,49864,-2714,-5.442804428,499.23,94.4,16438,16430,8,0.048691418
23222,2,ìåäCés,111988,107690,4298,3.991085523,43.43,2578.6,46349,42859,3490,8.142980471
23223,2,ëÂï{és,89170,85249,3921,4.599467442,33.66,2649.1,35669,33484,2185,6.525504719
23224,2,ímëΩés,84643,84768,-125,-0.147461306,45.9,1844.1,32985,31263,1722,5.508108627
23225,2,ímóßés,70494,68398,2096,3.064417088,16.31,4322.1,29269,27882,1387,4.974535543
23226,2,îˆí£àÆés,80812,81140,-328,-0.404239586,21.03,3842.7,31787,31009,778,2.508949015
23227,2,çÇïlés,46252,44027,2225,5.053717037,13.11,3528,17637,16090,1547,9.614667495
23228,2,ä‚ëqés,47563,47340,223,0.471060414,10.47,4542.8,20365,18963,1402,7.393344935
23229,2,ñLñæés,69119,69745,-626,-0.89755538,23.22,2976.7,27475,26872,603,2.24397142
23230,2,ì˙êiés,88010,84237,3773,4.479029405,34.91,2521.1,34179,33418,761,2.277215872
23231,2,ìcå¥és,62407,64119,-1712,-2.670035403,191.12,326.5,21433,21145,288,1.362024119
23232,2,à§êºés,63119,64978,-1859,-2.860968328,66.7,946.3,21111,20747,364,1.754470526
23233,2,ê¥ê{és,67393,65841,1552,2.357193846,17.35,3884.3,27045,25381,1664,6.556085261
23234,2,ñkñºå√âÆés,84153,81571,2582,3.165340624,18.37,4581,33665,31820,1845,5.798240101
23235,2,ñÌïxés,43275,43272,3,0.00693289,48.99,883.3,16039,15041,998,6.635197128
23236,2,Ç›ÇÊÇµés,61795,60098,1697,2.823721255,32.19,1919.7,22511,21054,1457,6.920300181
23237,2,Ç†Ç‹és,86904,86714,190,0.219111101,27.49,3161.3,33200,31355,1845,5.884228991
23238,2,í∑ãvéËés,57593,52022,5571,10.70893084,21.55,2672.5,25008,22240,2768,12.44604317
23300,c,à§ímåS,42872,41851,1021,2.439607178,18.03,2377.8,15750,14935,815,5.456980248
23302,3,ìåãΩí¨,42872,41851,1021,2.439607178,18.03,2377.8,15750,14935,815,5.456980248
23340,c,êºètì˙à‰åS,15183,14405,778,5.400902464,6.18,2456.8,6181,5776,405,7.011772853
23342,3,ñLéRí¨,15183,14405,778,5.400902464,6.18,2456.8,6181,5776,405,7.011772853
23360,c,íOâHåS,57087,56004,1083,1.933790444,24.8,2301.9,20969,19884,1085,5.456648562
23361,3,ëÂå˚í¨,23279,22446,833,3.711128932,13.61,1710.4,8309,7723,586,7.587724977
23362,3,ï}åKí¨,33808,33558,250,0.744978843,11.19,3021.3,12660,12161,499,4.10328098
23420,c,äCïîåS,72486,71104,1382,1.943631863,40.1,1807.6,28300,26651,1649,6.187385089
23424,3,ëÂé°í¨,30999,29891,1108,3.706801378,6.59,4703.9,12100,11285,815,7.221976074
23425,3,äIç]í¨,37087,36688,399,1.087549062,11.09,3344.2,14941,14078,863,6.130132121
23427,3,îÚìáë∫,4400,4525,-125,-2.762430939,22.42,196.3,1259,1288,-29,-2.251552795
23440,c,ímëΩåS,161794,163401,-1607,-0.983470113,165.43,978,61154,59627,1527,2.560920388
23441,3,à¢ãvî‰í¨,27767,25466,2301,9.035576848,23.8,1166.7,9625,8518,1107,12.99600845
23442,3,ìåâYí¨,49238,49800,-562,-1.128514056,31.14,1581.2,18504,18020,484,2.685904551
23445,3,ìÏímëΩí¨,18714,20549,-1835,-8.929874933,38.37,487.7,6985,7197,-212,-2.945671808
23446,3,î¸ïlí¨,23591,25178,-1587,-6.303121773,46.2,510.6,9329,9700,-371,-3.824742268
23447,3,ïêñLí¨,42484,42408,76,0.17921147,25.92,1639,16711,16192,519,3.205286561
23500,c,äzìcåS,39571,37930,1641,4.32639072,56.72,697.7,13682,12697,985,7.757738048
23501,3,çKìcí¨,39571,37930,1641,4.32639072,56.72,697.7,13682,12697,985,7.757738048
23560,c,ñkê›äyåS,9661,10862,-1201,-11.0568956,553.2,17.5,3940,4246,-306,-7.206782855
23561,3,ê›äyí¨,5077,5769,-692,-11.99514647,273.94,18.5,2015,2194,-179,-8.158614403
23562,3,ìåâhí¨,3448,3757,-309,-8.224647325,123.38,27.9,1435,1497,-62,-4.141616567
23563,3,ñLç™ë∫,1136,1336,-200,-14.97005988,155.88,7.3,490,555,-65,-11.71171171
24000,a,éOèdåß,1815827,1854724,-38897,-2.097185349,5774.39,314.5,718759,704607,14152,2.008495516
24001,b,ésïî,1589784,1621405,-31621,-1.950222184,4031.88,394.3,634053,619895,14158,2.283935183
24002,b,åSïî,226043,233319,-7276,-3.118477278,1742.5,129.7,84706,84712,-6,-0.007082822
24201,2,í√és,280016,285746,-5730,-2.005277414,711.11,393.8,114589,113092,1497,1.323701058
24202,2,élì˙ésés,311089,307766,3323,1.079716408,206.44,1506.9,128239,120020,8219,6.848025329
24203,2,à…ê®és,127868,130271,-2403,-1.844616223,208.35,613.7,50936,49361,1575,3.190778145
24204,2,èºç„és,163912,168017,-4105,-2.443205152,623.64,262.8,63933,63611,322,0.506201758
24205,2,åKñºés,140226,140290,-64,-0.045619788,136.68,1025.9,53431,51525,1906,3.699175158
24207,2,óÈé≠és,196251,199293,-3042,-1.526395809,194.46,1009.2,77453,75868,1585,2.089154848
24208,2,ñºí£és,78807,80284,-1477,-1.839718998,129.77,607.3,30381,29481,900,3.052813677
24209,2,îˆòhés,18015,20033,-2018,-10.07337892,192.71,93.5,8652,9219,-567,-6.150341686
24210,2,ãTéRés,50265,51023,-758,-1.485604531,191.04,263.1,19951,19213,738,3.841149222
24211,2,íπâHés,19455,21435,-1980,-9.237228831,107.34,181.2,7664,8057,-393,-4.877746059
24212,2,åFñÏés,17322,19662,-2340,-11.90112908,373.35,46.4,8165,9008,-843,-9.358348135
24214,2,Ç¢Ç»Ç◊és,45821,45684,137,0.299886175,219.83,208.4,17030,15972,1058,6.624092161
24215,2,éuñÄés,50360,54694,-4334,-7.924086737,178.94,281.4,20044,20553,-509,-2.476524108
24216,2,à…âÍés,90377,97207,-6830,-7.026242966,558.23,161.9,33585,34915,-1330,-3.809251038
24300,c,åKñºåS,6360,6855,-495,-7.221006565,15.74,404.1,2170,2250,-80,-3.555555556
24303,3,ñÿë]ñ¶í¨,6360,6855,-495,-7.221006565,15.74,404.1,2170,2250,-80,-3.555555556
24320,c,àıïŸåS,25350,25661,-311,-1.211955886,22.68,1117.7,8827,8580,247,2.878787879
24324,3,ìåàıí¨,25350,25661,-311,-1.211955886,22.68,1117.7,8827,8580,247,2.878787879
24340,c,éOèdåS,65518,63607,1911,3.00438631,121.73,538.2,24148,22558,1590,7.048497207
24341,3,å‘ñÏí¨,40208,39978,230,0.575316424,107.01,375.7,14297,13568,729,5.372936321
24343,3,í©ì˙í¨,10563,9626,937,9.734053605,5.99,1763.4,3835,3389,446,13.16022425
24344,3,êÏâzí¨,14747,14003,744,5.313147183,8.73,1689.2,6016,5601,415,7.40939118
24440,c,ëΩãCåS,47041,48687,-1646,-3.380779264,506.96,92.8,16541,16606,-65,-0.391424786
24441,3,ëΩãCí¨,14893,15438,-545,-3.530250032,103.06,144.5,5142,5278,-136,-2.576733611
24442,3,ñæòaí¨,22589,22833,-244,-1.068628739,41.04,550.4,7612,7422,190,2.559956885
24443,3,ëÂë‰í¨,9559,10416,-857,-8.227726575,362.86,26.3,3787,3906,-119,-3.046594982
24460,c,ìxâÔåS,45479,48626,-3147,-6.471846337,651.1,69.8,16949,17507,-558,-3.18729651
24461,3,ã èÈí¨,15439,15297,142,0.928286592,40.91,377.4,5236,5064,172,3.396524487
24470,3,ìxâÔí¨,8312,8692,-380,-4.371836171,134.98,61.6,2604,2605,-1,-0.038387716
24471,3,ëÂãIí¨,8942,9846,-904,-9.181393459,233.32,38.3,3691,3912,-221,-5.649284254
24472,3,ìÏà…ê®í¨,12786,14791,-2005,-13.55554053,241.89,52.9,5418,5926,-508,-8.572392845
24540,c,ñkñ¥òKåS,16343,18611,-2268,-12.18634141,256.53,63.7,7262,8088,-826,-10.21266073
24543,3,ãIñkí¨,16343,18611,-2268,-12.18634141,256.53,63.7,7262,8088,-826,-10.21266073
24560,c,ìÏñ¥òKåS,19952,21272,-1320,-6.205340354,167.75,118.9,8809,9123,-314,-3.441850269
24561,3,å‰ïlí¨,8746,9376,-630,-6.719283277,88.13,99.2,3862,4000,-138,-3.45
24562,3,ãIïÛí¨,11206,11896,-690,-5.800268998,79.62,140.7,4947,5123,-176,-3.435487019
25000,a,é†âÍåß,1413184,1410777,2407,0.1706152,4017.38,351.8,537294,517748,19546,3.775195655
25001,b,ésïî,1336260,1332046,4214,0.316355441,3660.07,365.1,510817,491652,19165,3.898082384
25002,b,åSïî,76924,78731,-1807,-2.295156927,357.32,215.3,26477,26096,381,1.459993869
25201,2,ëÂí√és,340972,337634,3338,0.988644509,464.51,734,136202,130335,5867,4.501476963
25202,2,ïFç™és,113819,112156,1663,1.482756161,196.87,578.1,45624,43896,1728,3.936577365
25203,2,í∑ïlés,118230,124131,-5901,-4.753848757,681.02,173.6,41757,43015,-1258,-2.9245612
25204,2,ãﬂç]î™î¶és,81225,81738,-513,-0.627615063,177.45,457.7,29729,28617,1112,3.885802146
25206,2,ëêí√és,137327,130874,6453,4.930696701,67.82,2024.9,60206,57318,2888,5.038556823
25207,2,éÁéRés,79837,76560,3277,4.28030303,55.74,1432.3,28975,26819,2156,8.039076774
25208,2,åIìåés,66764,63655,3109,4.884141073,52.69,1267.1,24582,22614,1968,8.702573627
25209,2,çbâÍés,90927,92704,-1777,-1.916853642,481.62,188.8,32329,31074,1255,4.038746219
25210,2,ñÏèFés,49893,49955,-62,-0.124111701,80.14,622.6,18136,17476,660,3.776607919
25211,2,åŒìÏés,54289,54614,-325,-0.595085509,70.4,771.2,21256,20463,793,3.875287104
25212,2,çÇìáés,50019,52486,-2467,-4.700301033,693.05,72.2,18141,18132,9,0.049636003
25213,2,ìåãﬂç]és,114220,115479,-1259,-1.090241516,388.37,294.1,40648,38941,1707,4.383554608
25214,2,ïƒå¥és,38738,40060,-1322,-3.300049925,250.39,154.7,13232,12952,280,2.161828289
25380,c,äóê∂åS,34322,35786,-1464,-4.090985302,162.15,211.7,11959,12091,-132,-1.091721115
25383,3,ì˙ñÏí¨,21882,22870,-988,-4.320069961,117.6,186.1,7697,7678,19,0.247460276
25384,3,ó≥â§í¨,12440,12916,-476,-3.685351502,44.55,279.2,4262,4413,-151,-3.421708588
25420,c,à§ímåS,20782,20118,664,3.300526891,37.97,547.3,7213,6761,452,6.685401568
25425,3,à§ëëí¨,20782,20118,664,3.300526891,37.97,547.3,7213,6761,452,6.685401568
25440,c,å¢è„åS,21820,22827,-1007,-4.41144259,157.2,138.8,7305,7244,61,0.842076201
25441,3,ñLãΩí¨,7424,7566,-142,-1.876817341,7.8,951.8,2603,2541,62,2.439984258
25442,3,çbó«í¨,7036,7500,-464,-6.186666667,13.63,516.2,2292,2320,-28,-1.206896552
25443,3,ëΩâÍí¨,7360,7761,-401,-5.166859941,135.77,54.2,2410,2383,27,1.133025598
26000,a,ãûìsï{,2610140,2636092,-25952,-0.984487643,4612.2,565.9,1152925,1122057,30868,2.751018888
26001,b,ésïî,2479115,2500487,-21372,-0.854713502,3864.49,641.5,1104177,1073899,30278,2.819445777
26002,b,åSïî,131025,135605,-4580,-3.377456584,747.7,175.2,48748,48158,590,1.225133934
26100,1,ãûìsés,1474570,1474015,555,0.037652263,827.83,1781.2,705758,681581,24177,3.547193951
26101,0,ãûìsés ñkãÊ,119537,122037,-2500,-2.048559044,94.88,1259.9,56885,56406,479,0.84920044
26102,0,ãûìsés è„ãûãÊ,84939,83264,1675,2.011673713,7.03,12082.4,46745,43389,3356,7.734679297
26103,0,ãûìsés ç∂ãûãÊ,168435,168802,-367,-0.217414486,246.77,682.6,83467,82067,1400,1.705923209
26104,0,ãûìsés íÜãûãÊ,109305,105306,3999,3.797504416,7.41,14751,59194,55772,3422,6.135695331
26105,0,ãûìsés ìåéRãÊ,38905,40528,-1623,-4.004638768,7.48,5201.2,21393,21114,279,1.321398125
26106,0,ãûìsés â∫ãûãÊ,82775,79287,3488,4.399207941,6.78,12208.7,47257,43651,3606,8.26097913
26107,0,ãûìsés ìÏãÊ,99859,98744,1115,1.129182533,15.81,6316.2,47186,45036,2150,4.773958611
26108,0,ãûìsés âEãûãÊ,204171,202943,1228,0.605096012,292.07,699,94386,90808,3578,3.940181482
26109,0,ãûìsés ïöå©ãÊ,280663,284085,-3422,-1.204569055,61.66,4551.8,125286,123597,1689,1.366538023
26110,0,ãûìsés éRâ»ãÊ,135192,136045,-853,-0.62699842,28.7,4710.5,60492,58321,2171,3.722501329
26111,0,ãûìsés êºãûãÊ,150789,152974,-2185,-1.428347301,59.24,2545.4,63467,61420,2047,3.332790622
26201,2,ïüíméRés,78956,79652,-696,-0.873801035,552.54,142.9,32141,30890,1251,4.049854322
26202,2,ïëíﬂés,84016,88669,-4653,-5.247606266,342.1,245.6,34702,35504,-802,-2.258900406
26203,2,àªïîés,33835,35836,-2001,-5.58377051,347.1,97.5,13738,14006,-268,-1.913465658
26204,2,âFé°és,184726,189609,-4883,-2.575299696,67.54,2735.1,73572,72907,665,0.912120921
26205,2,ã{í√és,18427,19948,-1521,-7.624824544,172.73,106.7,7769,8180,-411,-5.024449878
26206,2,ãTâ™és,89492,92399,-2907,-3.146137945,224.8,398.1,33928,33625,303,0.901115242
26207,2,èÈózés,76884,80037,-3153,-3.939428015,32.71,2350.5,29873,29972,-99,-0.330308288
26208,2,å¸ì˙és,53388,54328,-940,-1.730231188,7.72,6915.5,21346,21282,64,0.300723616
26209,2,í∑â™ãûés,80107,79844,263,0.329392315,19.17,4178.8,32476,31514,962,3.052611538
26210,2,î™î¶és,72748,74227,-1479,-1.992536409,24.35,2987.6,29247,28795,452,1.569716965
26211,2,ãûìcï”és,70866,67910,2956,4.352819909,42.92,1651.1,29707,27839,1868,6.710011136
26212,2,ãûíOå„és,55096,59038,-3942,-6.677055456,501.46,109.9,20490,20690,-200,-0.966650556
26213,2,ìÏíOés,33161,35214,-2053,-5.830067587,616.4,53.8,12780,12721,59,0.463800016
26214,2,ñÿí√êÏés,72843,69761,3082,4.417941257,85.13,855.7,26650,24393,2257,9.25265445
26300,c,â≥åPåS,15190,15121,69,0.456319027,5.97,2544.4,5993,5750,243,4.226086957
26303,3,ëÂéRçËí¨,15190,15121,69,0.456319027,5.97,2544.4,5993,5750,243,4.226086957
26320,c,ãvê¢åS,15819,15914,-95,-0.596958653,13.86,1141.3,6197,5870,327,5.570698467
26322,3,ãvå‰éRí¨,15819,15914,-95,-0.596958653,13.86,1141.3,6197,5870,327,5.570698467
26340,c,í‘äÏåS,17239,18158,-919,-5.06113008,76.21,226.2,6256,6207,49,0.789431287
26343,3,à‰éËí¨,7916,8447,-531,-6.286255475,18.04,438.8,3051,3110,-59,-1.897106109
26344,3,âFé°ìcå¥í¨,9323,9711,-388,-3.995469056,58.16,160.3,3205,3097,108,3.487245722
26360,c,ëääyåS,44368,44816,-448,-0.999642985,178.24,248.9,15848,15385,463,3.009424764
26364,3,ä}íuí¨,1369,1626,-257,-15.80565806,23.52,58.2,573,631,-58,-9.191759113
26365,3,òaë©í¨,3959,4482,-523,-11.66889781,64.93,61,1445,1509,-64,-4.241219351
26366,3,ê∏âÿí¨,36388,35630,758,2.127420713,25.68,1417,12761,12117,644,5.314846909
26367,3,ìÏéRèÈë∫,2652,3078,-426,-13.84015595,64.11,41.4,1069,1128,-59,-5.230496454
26400,c,ëDà‰åS,14457,15732,-1275,-8.104500381,303.09,47.7,5445,5660,-215,-3.798586572
26407,3,ãûíOîgí¨,14457,15732,-1275,-8.104500381,303.09,47.7,5445,5660,-215,-3.798586572
26460,c,ó^é”åS,23952,25864,-1912,-7.392514692,170.33,140.6,9009,9286,-277,-2.982985139
26463,3,à…ç™í¨,2110,2410,-300,-12.44813278,61.95,34.1,873,939,-66,-7.028753994
26465,3,ó^é”ñÏí¨,21842,23454,-1612,-6.873028055,108.38,201.5,8136,8347,-211,-2.527854319
27000,a,ëÂç„ï{,8838908,8865245,-26337,-0.297081468,1904.99,4639.9,3921923,3832386,89537,2.336325203
27001,b,ésïî,8657286,8676562,-19276,-0.222161727,1602.37,5402.8,3851855,3763586,88269,2.345342979
27002,b,åSïî,181622,188683,-7061,-3.742255529,302.62,600.2,70068,68800,1268,1.843023256
27100,1,ëÂç„és,2691742,2665314,26428,0.991552965,225.21,11952.1,1354202,1317990,36212,2.747517053
27102,0,ëÂç„és ìsìáãÊ,104735,102632,2103,2.049068517,6.08,17226.2,51552,50075,1477,2.949575637
27103,0,ëÂç„és ïüìáãÊ,72463,67290,5173,7.687620746,4.67,15516.7,37344,34379,2965,8.624450973
27104,0,ëÂç„és çüâ‘ãÊ,66640,65569,1071,1.633393829,19.25,3461.8,30720,29495,1225,4.153246313
27106,0,ëÂç„és êºãÊ,92418,83058,9360,11.26923355,5.21,17738.6,52214,47073,5141,10.92133495
27107,0,ëÂç„és ç`ãÊ,82063,84947,-2884,-3.395058095,7.86,10440.6,40408,40713,-305,-0.749146464
27108,0,ëÂç„és ëÂê≥ãÊ,65172,69510,-4338,-6.240828658,9.43,6911.1,29181,30521,-1340,-4.390419711
27109,0,ëÂç„és ìVâ§éõãÊ,75662,69775,5887,8.437119312,4.84,15632.6,38013,34730,3283,9.452922545
27111,0,ëÂç„és òQë¨ãÊ,69673,61745,7928,12.83990607,4.39,15870.8,47163,42392,4771,11.25448198
27113,0,ëÂç„és êºóÑêÏãÊ,95537,97504,-1967,-2.017353134,14.22,6718.5,42981,43608,-627,-1.437809576
27114,0,ëÂç„és ìåóÑêÏãÊ,175587,176585,-998,-0.565166917,13.27,13231.9,92519,91894,625,0.680131456
27115,0,ëÂç„és ìåê¨ãÊ,80592,80231,361,0.449950767,4.54,17751.5,39658,38920,738,1.896197328
27116,0,ëÂç„és ê∂ñÏãÊ,130194,134009,-3815,-2.846823721,8.37,15554.8,63394,62808,586,0.933002165
27117,0,ëÂç„és àÆãÊ,91619,92455,-836,-0.904223676,6.32,14496.7,43745,43842,-97,-0.221249031
27118,0,ëÂç„és èÈìåãÊ,164464,165832,-1368,-0.824931256,8.38,19625.8,76565,76043,522,0.686453717
27119,0,ëÂç„és à¢î{ñÏãÊ,107750,106350,1400,1.316408087,5.98,18018.4,50061,49318,743,1.506549333
27120,0,ëÂç„és èZãgãÊ,154315,155572,-1257,-0.807986013,9.4,16416.5,71725,73917,-2192,-2.965488318
27121,0,ëÂç„és ìåèZãgãÊ,126391,130724,-4333,-3.314617056,9.75,12963.2,57949,60057,-2108,-3.509998834
27122,0,ëÂç„és êºê¨ãÊ,111938,121972,-10034,-8.226478208,7.37,15188.3,69401,74466,-5065,-6.801761878
27123,0,ëÂç„és óÑêÏãÊ,176411,172078,4333,2.518044143,12.64,13956.6,94470,91116,3354,3.681021994
27124,0,ëÂç„és íﬂå©ãÊ,111528,111182,346,0.311201454,8.17,13650.9,46345,45264,1081,2.388211382
27125,0,ëÂç„és èZîVç]ãÊ,123035,127210,-4175,-3.281974688,20.61,5969.7,56990,56593,397,0.701500186
27126,0,ëÂç„és ïΩñÏãÊ,196839,200005,-3166,-1.582960426,15.28,12882.1,88842,86500,2342,2.707514451
27127,0,ëÂç„és ñkãÊ,123679,110392,13287,12.03619828,10.34,11961.2,74007,65204,8803,13.50070548
27128,0,ëÂç„és íÜâõãÊ,93037,78687,14350,18.23681167,8.87,10489,58955,49062,9893,20.16428193
27140,1,ç‰és,839891,841966,-2075,-0.246447006,149.81,5606.4,350318,344465,5853,1.699156663
27141,0,ç‰és ç‰ãÊ,148016,148748,-732,-0.492107457,23.65,6258.6,69109,67426,1683,2.496069765
27142,0,ç‰és íÜãÊ,124518,123532,986,0.798173753,17.88,6964.1,48576,47203,1373,2.908713429
27143,0,ç‰és ìåãÊ,85267,85444,-177,-0.207153223,10.49,8128.4,34722,34404,318,0.924311127
27144,0,ç‰és êºãÊ,135864,133622,2242,1.677867417,28.61,4748.8,54597,53442,1155,2.161221511
27145,0,ç‰és ìÏãÊ,147903,154779,-6876,-4.442463125,40.39,3661.9,60380,61008,-628,-1.029373197
27146,0,ç‰és ñkãÊ,159110,156561,2549,1.628119391,15.6,10199.4,68616,67116,1500,2.234936528
27147,0,ç‰és î¸å¥ãÊ,39213,39280,-67,-0.170570265,13.2,2970.7,14318,13866,452,3.259772104
27202,2,ä›òaìcés,194862,199234,-4372,-2.19440457,72.55,2685.9,75232,75353,-121,-0.160577548
27203,2,ñLíÜés,394495,389341,5154,1.323775302,36.39,10840.8,170274,166677,3597,2.1580662
27204,2,írìcés,103041,104229,-1188,-1.139797945,22.14,4654.1,45638,45661,-23,-0.050371214
27205,2,êÅìcés,374526,355798,18728,5.263660841,36.09,10377.6,169405,154702,14703,9.50407881
27206,2,êÚëÂí√és,75880,77548,-1668,-2.150925878,14.31,5302.6,31064,30962,102,0.329436083
27207,2,çÇíŒés,351831,357359,-5528,-1.546903814,105.29,3341.5,147538,145426,2112,1.452285011
27208,2,äLíÀés,88703,90492,-1789,-1.97697034,43.93,2019.2,33301,32986,315,0.954950585
27209,2,éÁå˚és,143068,146697,-3629,-2.473806554,12.71,11256.3,65638,65129,509,0.781525895
27210,2,ñáï˚és,403893,407978,-4085,-1.001279481,65.12,6202.3,167377,163983,3394,2.06972674
27211,2,àÔñÿés,280170,274822,5348,1.945986857,76.49,3662.8,116704,112282,4422,3.938298213
27212,2,î™îˆés,268562,271460,-2898,-1.067560598,41.72,6437.2,109945,108704,1241,1.141632323
27213,2,êÚç≤ñÏés,101025,100801,224,0.222220018,56.51,1787.7,41499,39084,2415,6.178999079
27214,2,ïxìcó—és,114076,119576,-5500,-4.599585201,39.72,2872,45638,45600,38,0.083333333
27215,2,êQâÆêÏés,237814,238204,-390,-0.16372521,24.7,9628.1,101415,99178,2237,2.255540543
27216,2,âÕì‡í∑ñÏés,107114,112490,-5376,-4.779091475,109.63,977.1,42063,41339,724,1.751372796
27217,2,èºå¥és,120697,124594,-3897,-3.127758961,16.66,7244.7,49610,49218,392,0.796456581
27218,2,ëÂìåés,122982,127534,-4552,-3.56924428,18.27,6731.4,52022,52381,-359,-0.685363013
27219,2,òaêÚés,186128,184988,1140,0.61625619,84.98,2190.3,70855,68342,2513,3.677094612
27220,2,ñ•ñ és,133418,129895,3523,2.712190616,47.9,2785.3,56860,53560,3300,6.161314414
27221,2,îêå¥és,71276,74773,-3497,-4.676821848,25.33,2813.9,28999,29685,-686,-2.310931447
27222,2,âHâgñÏés,112695,117681,-4986,-4.236877661,26.45,4260.7,44076,44693,-617,-1.380529389
27223,2,ñÂê^és,122808,130282,-7474,-5.736786356,12.3,9984.4,55458,57880,-2422,-4.184519696
27224,2,ê€í√és,85054,83720,1334,1.593406593,14.87,5719.8,36801,34987,1814,5.184782919
27225,2,çÇêŒés,56485,59572,-3087,-5.181964681,11.29,5003.1,22480,23012,-532,-2.311837302
27226,2,ì°à‰éõés,65454,66165,-711,-1.074586262,8.89,7362.7,27137,26754,383,1.431561636
27227,2,ìåëÂç„és,502605,509533,-6928,-1.35967641,61.78,8135.4,223040,217762,5278,2.423747027
27228,2,êÚìÏés,62500,64403,-1903,-2.954831297,48.98,1276,22785,22604,181,0.800743231
27229,2,élûäìÎés,56092,57554,-1462,-2.540223095,18.69,3001.2,22076,21726,350,1.610973028
27230,2,åñÏés,76459,77686,-1227,-1.579435162,25.55,2992.5,28920,28488,432,1.51642797
27231,2,ëÂç„ã∑éRés,57803,58227,-424,-0.728184519,11.92,4849.2,22878,22473,405,1.802162595
27232,2,ç„ìÏés,54137,56646,-2509,-4.429262437,36.17,1496.7,20607,20500,107,0.52195122
27300,c,éOìáåS,29986,28935,1051,3.632279247,16.81,1783.8,12008,11248,760,6.756756757
27301,3,ìáñ{í¨,29986,28935,1051,3.632279247,16.81,1783.8,12008,11248,760,6.756756757
27320,c,ñLî\åS,30199,33639,-3440,-10.22622551,133.09,226.9,11366,11724,-358,-3.053565336
27321,3,ñLî\í¨,19941,21989,-2048,-9.313747783,34.34,580.7,7694,7871,-177,-2.248761276
27322,3,î\ê®í¨,10258,11650,-1392,-11.94849785,98.75,103.9,3672,3853,-181,-4.697638204
27340,c,êÚñkåS,17297,18149,-852,-4.694473525,3.97,4356.9,6662,6744,-82,-1.215895611
27341,3,íââ™í¨,17297,18149,-852,-4.694473525,3.97,4356.9,6662,6744,-82,-1.215895611
27360,c,êÚìÏåS,68832,70685,-1853,-2.621489708,72.03,955.6,26843,25689,1154,4.492195103
27361,3,åFéÊí¨,44466,45096,-630,-1.397019691,17.24,2579.2,16688,15775,913,5.787638669
27362,3,ìcêKí¨,8419,8085,334,4.131106988,5.62,1498,3761,3255,506,15.5453149
27366,3,ñ¶í¨,15947,17504,-1557,-8.895109689,49.18,324.3,6394,6659,-265,-3.979576513
27380,c,ìÏâÕì‡åS,35308,37275,-1967,-5.276995305,76.72,460.2,13189,13395,-206,-1.537887271
27381,3,ëæéqí¨,13739,14220,-481,-3.382559775,14.17,969.6,5060,4881,179,3.667281295
27382,3,âÕìÏí¨,16191,17040,-849,-4.982394366,25.26,641,6105,6426,-321,-4.995331466
27383,3,êÁëÅê‘ç„ë∫,5378,6015,-637,-10.59019119,37.3,144.2,2024,2088,-64,-3.0651341
28000,a,ï∫å…åß,5536989,5588133,-51144,-0.915225175,8400.9,659.1,2314206,2255318,58888,2.611073028
28001,b,ésïî,5277276,5318635,-41359,-0.777624334,6660.52,792.3,2222054,2164851,57203,2.642352753
28002,b,åSïî,259713,269498,-9785,-3.630824719,1740.38,149.2,92152,90467,1685,1.862557618
28100,1,ê_åÀés,1537860,1544200,-6340,-0.410568579,557.02,2760.9,705061,684183,20878,3.051522765
28101,0,ê_åÀés ìåìÂãÊ,213727,210408,3319,1.577411505,34.02,6282.4,97147,94039,3108,3.30501175
28102,0,ê_åÀés ìÂãÊ,136130,133451,2679,2.0074784,32.66,4168.1,67356,65178,2178,3.341618338
28105,0,ê_åÀés ï∫å…ãÊ,106983,108304,-1321,-1.219714877,14.68,7287.7,57810,56954,856,1.502967307
28106,0,ê_åÀés í∑ìcãÊ,97952,101624,-3672,-3.613319688,11.36,8622.5,48722,48224,498,1.032680823
28107,0,ê_åÀés ê{ñÅãÊ,162533,167475,-4942,-2.950888192,28.93,5618.1,73295,71657,1638,2.285889725
28108,0,ê_åÀés êÇêÖãÊ,219554,220411,-857,-0.38881907,28.11,7810.5,95512,94016,1496,1.591218516
28109,0,ê_åÀés ñkãÊ,219868,226836,-6968,-3.071822815,240.29,915,87233,86350,883,1.022582513
28110,0,ê_åÀés íÜâõãÊ,135218,126393,8825,6.982190469,28.97,4667.5,80917,73814,7103,9.622835776
28111,0,ê_åÀés êºãÊ,245895,249298,-3403,-1.365033013,138.01,1781.7,97069,93951,3118,3.318751264
28201,2,ïPòHés,535807,536270,-463,-0.086337106,534.33,1002.8,212563,205587,6976,3.39321066
28202,2,ìÚçËés,452571,453748,-1177,-0.259395083,50.72,8922.9,210253,209343,910,0.434693302
28203,2,ñæêŒés,293509,290959,2550,0.876412141,49.42,5939.1,121866,116948,4918,4.20528782
28204,2,êºã{és,488147,482640,5507,1.141016078,99.96,4883.4,210890,202648,8242,4.067150922
28205,2,èFñ{és,44271,47254,-2983,-6.312693105,182.38,242.7,18090,18447,-357,-1.935274028
28206,2,à∞âÆés,95440,93238,2202,2.36169802,18.47,5167.3,41959,39753,2206,5.549266722
28207,2,à…íOés,197040,196127,913,0.465514692,25,7881.6,78904,77263,1641,2.123914422
28208,2,ëäê∂és,30142,31158,-1016,-3.260799795,90.4,333.4,12135,12141,-6,-0.049419323
28209,2,ñLâ™és,82269,85592,-3323,-3.882372184,697.55,117.9,30152,29741,411,1.381930668
28210,2,â¡å√êÏés,267434,266937,497,0.186186254,138.48,1931.2,103457,99645,3812,3.825580812
28212,2,ê‘ï‰és,48591,50523,-1932,-3.82400095,126.86,383,18714,18826,-112,-0.594921917
28213,2,êºòeés,40890,42802,-1912,-4.467080978,132.44,308.7,15045,14989,56,0.373607312
28214,2,ïÛ˙úés,224977,225700,-723,-0.32033673,101.8,2210,94206,91737,2469,2.691389516
28215,2,éOñÿés,77310,81009,-3699,-4.566159316,176.51,438,28584,28506,78,0.273626605
28216,2,çÇçªés,91065,93901,-2836,-3.020202128,34.45,2643.4,36330,35737,593,1.659344657
28217,2,êÏêºés,156481,156423,58,0.037078946,53.44,2928.2,62653,60584,2069,3.415093094
28218,2,è¨ñÏés,48605,49680,-1075,-2.163848631,92.94,523,16856,16470,386,2.343655131
28219,2,éOìcés,112732,114216,-1484,-1.299292569,210.32,536,41044,40068,976,2.43585904
28220,2,â¡êºés,44352,47993,-3641,-7.586523035,150.98,293.8,15356,15188,168,1.106136424
28221,2,é¬éRés,41506,43263,-1757,-4.061207036,377.59,109.9,15565,15342,223,1.453526268
28222,2,ó{ïÉés,24293,26501,-2208,-8.331761066,422.91,57.4,8713,9062,-349,-3.851246965
28223,2,íOîgés,64689,67757,-3068,-4.527945452,493.21,131.2,22563,22461,102,0.454120476
28224,2,ìÏÇ†ÇÌÇ∂és,46948,49834,-2886,-5.791226873,229.01,205,16964,16981,-17,-0.10011189
28225,2,í©óàés,30855,32814,-1959,-5.970012799,403.06,76.6,11497,11655,-158,-1.355641356
28226,2,íWòHés,43925,46459,-2534,-5.454271508,184.35,238.3,17508,17436,72,0.412938747
28227,2,é≥àæés,37792,40938,-3146,-7.684791636,658.54,57.4,12736,13174,-438,-3.32473053
28228,2,â¡ìåés,40332,40181,151,0.375799507,157.55,256,15104,14133,971,6.870445058
28229,2,ÇΩÇ¬ÇÃés,77443,80518,-3075,-3.819021834,210.87,367.3,27286,26803,483,1.802037085
28300,c,êÏï”åS,30851,31739,-888,-2.797819717,90.33,341.5,10779,10547,232,2.199677634
28301,3,íññºêÏí¨,30851,31739,-888,-2.797819717,90.33,341.5,10779,10547,232,2.199677634
28360,c,ëΩâ¬åS,21222,23104,-1882,-8.145775623,185.19,114.6,6648,6709,-61,-0.909226412
28365,3,ëΩâ¬í¨,21222,23104,-1882,-8.145775623,185.19,114.6,6648,6709,-61,-0.909226412
28380,c,â¡å√åS,64788,64209,579,0.901742746,44.05,1470.8,24239,22807,1432,6.278774061
28381,3,àÓî¸í¨,31033,31026,7,0.022561722,34.92,888.7,11018,10226,792,7.744963818
28382,3,îdñÅí¨,33755,33183,572,1.723774222,9.13,3697.2,13221,12581,640,5.087036007
28440,c,ê_çËåS,43518,45407,-1889,-4.160151519,330.7,131.6,15037,14802,235,1.587623294
28442,3,ésêÏí¨,12311,13288,-977,-7.352498495,82.67,148.9,4335,4350,-15,-0.344827586
28443,3,ïüçËí¨,19745,19830,-85,-0.42864347,45.79,431.2,6904,6639,265,3.991564995
28446,3,ê_âÕí¨,11462,12289,-827,-6.729595573,202.23,56.7,3798,3813,-15,-0.393391031
28460,c,óKï€åS,33699,33438,261,0.780549076,22.61,1490.4,12087,11640,447,3.840206186
28464,3,ëæéqí¨,33699,33438,261,0.780549076,22.61,1490.4,12087,11640,447,3.840206186
28480,c,ê‘ï‰åS,15233,16636,-1403,-8.433517673,150.26,101.4,5714,5870,-156,-2.65758092
28481,3,è„åSí¨,15233,16636,-1403,-8.433517673,150.26,101.4,5714,5870,-156,-2.65758092
28500,c,ç≤ópåS,17508,19265,-1757,-9.120166104,307.44,56.9,6108,6301,-193,-3.063005872
28501,3,ç≤ópí¨,17508,19265,-1757,-9.120166104,307.44,56.9,6108,6301,-193,-3.063005872
28580,c,î¸ï˚åS,32894,35700,-2806,-7.859943978,609.78,53.9,11540,11791,-251,-2.128742261
28585,3,çÅî¸í¨,18076,19696,-1620,-8.225020309,368.77,49,6224,6449,-225,-3.48891301
28586,3,êVâ∑êÚí¨,14818,16004,-1186,-7.410647338,241.01,61.5,5316,5342,-26,-0.486709098
29000,a,ìﬁó«åß,1365008,1400728,-35720,-2.550102518,3690.94,369.8,530325,523523,6802,1.299274339
29001,b,ésïî,1082897,1107167,-24270,-2.192081231,1272.23,851.2,424915,418398,6517,1.557607828
29002,b,åSïî,282111,293561,-11450,-3.900381863,2418.7,116.6,105410,105125,285,0.271105826
29201,2,ìﬁó«és,360439,366591,-6152,-1.678164494,276.94,1301.5,149274,147421,1853,1.256944397
29202,2,ëÂòaçÇìcés,64856,68451,-3595,-5.251932039,16.48,3935.4,25604,25815,-211,-0.817354251
29203,2,ëÂòaåSéRés,87180,89023,-1843,-2.070251508,42.69,2042.2,34149,33235,914,2.750112833
29204,2,ìVóùés,67437,69178,-1741,-2.516696059,86.42,780.3,25725,25396,329,1.295479603
29205,2,äÄå¥és,124126,125605,-1479,-1.177500896,39.56,3137.7,49863,48740,1123,2.304062372
29206,2,ç˜à‰és,57253,60146,-2893,-4.809962425,98.91,578.8,21648,21417,231,1.078582435
29207,2,å‹ûäés,31012,34460,-3448,-10.00580383,292.02,106.2,11171,11738,-567,-4.830465156
29208,2,å‰èäés,26888,30287,-3399,-11.22263677,60.58,443.8,10416,10603,-187,-1.763651797
29209,2,ê∂ãÓés,118297,118113,184,0.155783021,53.15,2225.7,45597,44484,1113,2.502023199
29210,2,çÅé≈és,77637,75227,2410,3.203636992,24.26,3200.2,27777,26131,1646,6.299031801
29211,2,äãèÈés,36655,35859,796,2.219805349,33.72,1087,12546,11891,655,5.508367673
29212,2,âFë…és,31117,34227,-3110,-9.086393783,247.5,125.7,11145,11527,-382,-3.313958532
29320,c,éRï”åS,3676,4107,-431,-10.49427806,66.52,55.3,1144,1196,-52,-4.347826087
29322,3,éRìYë∫,3676,4107,-431,-10.49427806,66.52,55.3,1144,1196,-52,-4.347826087
29340,c,ê∂ãÓåS,77196,78830,-1634,-2.072814918,51.27,1505.7,29455,29186,269,0.921674776
29342,3,ïΩåQí¨,18897,19727,-830,-4.207431439,23.9,790.7,7105,7090,15,0.211565585
29343,3,éOãΩí¨,23541,23440,101,0.430887372,8.79,2678.2,9148,8978,170,1.893517487
29344,3,î¡îµí¨,27314,27734,-420,-1.514386673,14.27,1914.1,10330,10184,146,1.433621367
29345,3,à¿ìgí¨,7444,7929,-485,-6.11678648,4.31,1727.1,2872,2934,-62,-2.113156101
29360,c,àÈèÈåS,47047,48214,-1167,-2.420458788,31.09,1513.3,17329,16743,586,3.499970137
29361,3,êÏêºí¨,8500,8653,-153,-1.768172888,5.93,1433.4,3233,3152,81,2.569796954
29362,3,éOëÓí¨,6838,7440,-602,-8.09139785,4.06,1684.2,2628,2637,-9,-0.341296928
29363,3,ìcå¥ñ{í¨,31709,32121,-412,-1.28264998,21.09,1503.5,11468,10954,514,4.692349827
29380,c,âFë…åS,3307,3997,-690,-17.26294721,127.34,26,1392,1488,-96,-6.451612903
29385,3,ë]é¢ë∫,1549,1895,-346,-18.2585752,47.76,32.4,644,675,-31,-4.592592593
29386,3,å‰èÒë∫,1758,2102,-344,-16.36536632,79.58,22.1,748,813,-65,-7.995079951
29400,c,çÇésåS,12717,13513,-796,-5.890623844,49.89,254.9,4174,4234,-60,-1.417099669
29401,3,çÇéÊí¨,7191,7657,-466,-6.085934439,25.79,278.8,2395,2435,-40,-1.642710472
29402,3,ñæì˙çÅë∫,5526,5856,-330,-5.635245902,24.1,229.3,1779,1799,-20,-1.111728738
29420,c,ñkäãèÈåS,96606,97511,-905,-0.928100419,37.68,2563.9,35178,34274,904,2.637567836
29424,3,è„ñqí¨,22093,23728,-1635,-6.890593392,6.14,3598.2,8156,8368,-212,-2.533460803
29425,3,â§éõí¨,23050,22182,868,3.91308268,7.01,3288.2,9292,8718,574,6.584078917
29426,3,çLóÀí¨,33523,33070,453,1.369821591,16.3,2056.6,11017,10525,492,4.674584323
29427,3,âÕçáí¨,17940,18531,-591,-3.189250445,8.23,2179.8,6713,6663,50,0.750412727
29440,c,ãgñÏåS,41562,47389,-5827,-12.29610247,2054.91,20.2,16738,18004,-1266,-7.031770718
29441,3,ãgñÏí¨,7398,8642,-1244,-14.39481601,95.65,77.3,2939,3172,-233,-7.345523329
29442,3,ëÂóÑí¨,18071,19176,-1105,-5.762411348,38.1,474.3,6524,6609,-85,-1.286124981
29443,3,â∫ésí¨,5662,7020,-1358,-19.34472934,61.99,91.3,2237,2434,-197,-8.093672966
29444,3,çïëÍë∫,655,840,-185,-22.02380952,47.7,13.7,311,357,-46,-12.88515406
29446,3,ìVêÏë∫,1353,1572,-219,-13.93129771,175.66,7.7,624,711,-87,-12.23628692
29447,3,ñÏîóêÏë∫,449,524,-75,-14.3129771,154.9,2.9,227,249,-22,-8.835341366
29449,3,è\í√êÏë∫,3508,4107,-599,-14.58485513,672.38,5.2,1577,1831,-254,-13.87220098
29450,3,â∫ñkéRë∫,892,1039,-147,-14.14821944,133.39,6.7,517,559,-42,-7.513416816
29451,3,è„ñkéRë∫,510,683,-173,-25.32942899,274.22,1.9,270,361,-91,-25.20775623
29452,3,êÏè„ë∫,1320,1643,-323,-19.65916007,269.26,4.9,683,786,-103,-13.1043257
29453,3,ìåãgñÏë∫,1744,2143,-399,-18.61875875,131.65,13.2,829,935,-106,-11.3368984
30000,a,òaâÃéRåß,963850,1002198,-38348,-3.826389596,4724.68,204,391924,393553,-1629,-0.413921378
30001,b,ésïî,753292,777550,-24258,-3.11979937,2070.11,363.9,307580,307042,538,0.175220328
30002,b,åSïî,210558,224648,-14090,-6.272034472,2654.58,79.3,84344,86511,-2167,-2.504883772
30201,2,òaâÃéRés,364285,370364,-6079,-1.641358231,208.84,1744.3,152866,152569,297,0.19466602
30202,2,äCìÏés,51879,54783,-2904,-5.300914517,101.06,513.3,20680,20750,-70,-0.337349398
30203,2,ã¥ñ{és,63609,66361,-2752,-4.14701406,130.55,487.2,23626,23468,158,0.673257201
30204,2,óLìcés,28479,30592,-2113,-6.907034519,36.89,772,10572,10735,-163,-1.518397764
30205,2,å‰ñVés,24803,26111,-1308,-5.009383019,43.91,564.9,9907,9993,-86,-0.860602422
30206,2,ìcï”és,74777,79119,-4342,-5.487935894,1026.91,72.8,32200,32693,-493,-1.507968067
30207,2,êVã{és,29334,31498,-2164,-6.870277478,255.23,114.9,13608,14063,-455,-3.235440518
30208,2,ãIÇÃêÏés,62650,65840,-3190,-4.845078979,228.21,274.5,23454,23226,228,0.981658486
30209,2,ä‚èoés,53476,52882,594,1.12325555,38.51,1388.6,20667,19545,1122,5.740598619
30300,c,äCëêåS,9211,10391,-1180,-11.35598114,128.34,71.8,3763,3971,-208,-5.237975321
30304,3,ãIî¸ñÏí¨,9211,10391,-1180,-11.35598114,128.34,71.8,3763,3971,-208,-5.237975321
30340,c,à…ìsåS,24736,27168,-2432,-8.951707892,332.88,74.3,9428,9992,-564,-5.644515613
30341,3,Ç©Ç¬ÇÁÇ¨í¨,17009,18230,-1221,-6.69775096,151.69,112.1,6319,6463,-144,-2.228067461
30343,3,ã„ìxéRí¨,4384,4963,-579,-11.66633085,44.15,99.3,1647,1741,-94,-5.399195864
30344,3,çÇñÏí¨,3343,3975,-632,-15.89937107,137.03,24.4,1462,1788,-326,-18.23266219
30360,c,óLìcåS,45814,48086,-2272,-4.724867945,437.97,104.6,16688,16692,-4,-0.023963575
30361,3,ìíêÛí¨,12205,13210,-1005,-7.607872824,20.79,587.1,4760,4971,-211,-4.244618789
30362,3,çLêÏí¨,7230,7714,-484,-6.274306456,65.33,110.7,2506,2496,10,0.400641026
30366,3,óLìcêÏí¨,26379,27162,-783,-2.882703777,351.84,75,9422,9225,197,2.135501355
30380,c,ì˙çÇåS,51550,54602,-3052,-5.589538845,655.38,78.7,18944,19313,-369,-1.910630146
30381,3,î¸ïlí¨,7482,8077,-595,-7.366596509,12.77,585.9,2962,3086,-124,-4.018146468
30382,3,ì˙çÇí¨,7641,7432,209,2.812163617,46.4,164.7,2783,2648,135,5.098187311
30383,3,óRó«í¨,5839,6508,-669,-10.27965581,30.73,190,2213,2419,-206,-8.515915668
30390,3,àÛìÏí¨,8067,8606,-539,-6.263072275,113.62,71,2919,3015,-96,-3.184079602
30391,3,Ç›Ç»Ç◊í¨,12741,13470,-729,-5.412026726,120.28,105.9,4421,4395,26,0.591581342
30392,3,ì˙çÇêÏí¨,9780,10509,-729,-6.936911219,331.59,29.5,3646,3750,-104,-2.773333333
30400,c,êºñ¥òKåS,40650,42233,-1583,-3.748253735,432.8,93.9,17460,17340,120,0.692041523
30401,3,îíïlí¨,21534,22696,-1162,-5.119844907,200.96,107.2,9508,9616,-108,-1.12312812
30404,3,è„ïxìcí¨,14986,14807,179,1.208887688,57.37,261.2,6025,5610,415,7.397504456
30406,3,Ç∑Ç≥Ç›í¨,4130,4730,-600,-12.68498943,174.46,23.7,1927,2114,-187,-8.845789972
30420,c,ìåñ¥òKåS,38597,42168,-3571,-8.468506925,667.21,57.8,18061,19203,-1142,-5.94698745
30421,3,ìﬂíqèüâYí¨,15681,17080,-1399,-8.190866511,183.31,85.5,7292,7723,-431,-5.580732876
30422,3,ëæíní¨,3086,3250,-164,-5.046153846,5.81,531.2,1382,1417,-35,-2.470007057
30424,3,å√ç¿êÏí¨,2825,3103,-278,-8.959071866,294.23,9.6,1382,1484,-102,-6.873315364
30427,3,ñkéRë∫,446,486,-40,-8.230452675,48.2,9.3,239,256,-17,-6.640625
30428,3,ã¯ñ{í¨,16559,18249,-1690,-9.260781413,135.67,122.1,7766,8323,-557,-6.69229845
31000,a,íπéÊåß,573648,588667,-15019,-2.551357559,3507.05,163.6,215542,211964,3578,1.688022494
31001,b,ésïî,426404,431699,-5295,-1.226549054,1198.81,355.7,166348,162034,4314,2.662404187
31002,b,åSïî,147244,156968,-9724,-6.194893227,2308.24,63.8,49194,49930,-736,-1.474063689
31201,2,íπéÊés,193766,197449,-3683,-1.865291797,765.31,253.2,75384,73288,2096,2.859949787
31202,2,ïƒéqés,149382,148271,1111,0.74930364,132.42,1128.1,59570,57610,1960,3.40218712
31203,2,ëqãgés,49070,50720,-1650,-3.253154574,272.06,180.4,18385,18266,119,0.651483631
31204,2,ã´ç`és,34186,35259,-1073,-3.043194645,29.02,1178,13009,12870,139,1.08003108
31300,c,ä‚î¸åS,11488,12362,-874,-7.070053389,122.32,93.9,3977,3982,-5,-0.125565043
31302,3,ä‚î¸í¨,11488,12362,-874,-7.070053389,122.32,93.9,3977,3982,-5,-0.125565043
31320,c,î™ì™åS,27415,30018,-2603,-8.671463788,630.58,43.5,9104,9428,-324,-3.436571913
31325,3,é·ç˜í¨,3272,3873,-601,-15.51768655,199.18,16.4,1261,1405,-144,-10.24911032
31328,3,íqì™í¨,7153,7718,-565,-7.320549365,224.7,31.8,2487,2569,-82,-3.191903464
31329,3,î™ì™í¨,16990,18427,-1437,-7.798339393,206.71,82.2,5356,5454,-98,-1.796846351
31360,c,ìåîååS,55297,58017,-2720,-4.688281021,508.37,108.8,18357,18447,-90,-0.487884209
31364,3,éOí©í¨,6482,7015,-533,-7.598004277,233.52,27.8,2291,2385,-94,-3.94129979
31370,3,ìíóúïlí¨,16557,17029,-472,-2.771742322,77.94,212.4,5482,5418,64,1.181247693
31371,3,ã’âYí¨,17423,18531,-1108,-5.979170039,139.97,124.5,5773,5834,-61,-1.045594789
31372,3,ñkâhí¨,14835,15442,-607,-3.930837974,56.94,260.5,4811,4810,1,0.020790021
31380,c,êºîååS,42005,43987,-1982,-4.505876736,447.51,93.9,13540,13529,11,0.081306822
31384,3,ì˙ãgí√ë∫,3449,3339,110,3.294399521,4.2,821.2,1147,1070,77,7.196261682
31386,3,ëÂéRí¨,16480,17491,-1011,-5.780115488,189.83,86.8,5297,5338,-41,-0.768077932
31389,3,ìÏïîí¨,10956,11536,-580,-5.027739251,114.03,96.1,3496,3511,-15,-0.42722871
31390,3,îå„Àí¨,11120,11621,-501,-4.31116083,139.44,79.7,3600,3610,-10,-0.27700831
31400,c,ì˙ñÏåS,11039,12584,-1545,-12.27749523,599.46,18.4,4216,4544,-328,-7.218309859
31401,3,ì˙ìÏí¨,4764,5460,-696,-12.74725275,340.96,14,1933,2099,-166,-7.90852787
31402,3,ì˙ñÏí¨,3273,3745,-472,-12.6034713,133.98,24.4,1276,1371,-95,-6.929248724
31403,3,ç]ï{í¨,3002,3379,-377,-11.15714708,124.52,24.1,1007,1074,-67,-6.238361266
32000,a,ìáç™åß,694188,717397,-23209,-3.235168254,6708.23,103.5,264481,262219,2262,0.862637719
32001,b,ésïî,622033,639272,-17239,-2.696661202,4299.26,144.7,235259,231690,3569,1.540420389
32002,b,åSïî,72155,78125,-5970,-7.6416,2408.97,30,29222,30529,-1307,-4.281175276
32201,2,èºç]és,206407,208613,-2206,-1.057460465,572.99,360.2,82993,81166,1827,2.250942513
32202,2,ïlìcés,58120,61713,-3593,-5.822112035,690.66,84.2,24508,24972,-464,-1.858081051
32203,2,èoâ_és,171576,171485,91,0.053065866,624.36,274.8,59719,55952,3767,6.732556477
32204,2,âvìcés,47701,50015,-2314,-4.626612016,733.19,65.1,19033,19243,-210,-1.091305929
32205,2,ëÂìcés,35167,37996,-2829,-7.445520581,435.71,80.7,13634,14312,-678,-4.737283399
32206,2,à¿óàés,39553,41836,-2283,-5.45702266,420.93,94,12796,12820,-24,-0.187207488
32207,2,ç]í√és,24450,25697,-1247,-4.852706542,268.24,91.1,10058,10320,-262,-2.53875969
32209,2,â_ìÏés,39059,41917,-2858,-6.818236038,553.18,70.6,12518,12905,-387,-2.99883766
32340,c,êmëΩåS,13071,14456,-1385,-9.580796901,368.01,35.5,4471,4713,-242,-5.134733715
32343,3,âúèoâ_í¨,13071,14456,-1385,-9.580796901,368.01,35.5,4471,4713,-242,-5.134733715
32380,c,î—êŒåS,5028,5534,-506,-9.14347669,242.88,20.7,1842,1944,-102,-5.24691358
32386,3,î—ìÏí¨,5028,5534,-506,-9.14347669,242.88,20.7,1842,1944,-102,-5.24691358
32440,c,óWíqåS,19439,21210,-1771,-8.349834984,808.63,24,7682,8333,-651,-7.812312493
32441,3,êÏñ{í¨,3440,3900,-460,-11.79487179,106.43,32.3,1454,1666,-212,-12.72509004
32448,3,î¸ãΩí¨,4899,5351,-452,-8.447019249,282.92,17.3,2006,2157,-151,-7.000463607
32449,3,óWìÏí¨,11100,11959,-859,-7.182874822,419.29,26.5,4222,4510,-288,-6.385809313
32500,c,é≠ë´åS,14029,15237,-1208,-7.92806983,643.54,21.8,6092,6216,-124,-1.994851995
32501,3,í√òañÏí¨,7658,8427,-769,-9.125430165,307.03,24.9,3299,3411,-112,-3.283494576
32505,3,ãgâÍí¨,6371,6810,-439,-6.44640235,336.5,18.9,2793,2805,-12,-0.427807487
32520,c,âBäÚåS,20588,21688,-1100,-5.071929177,345.92,59.6,9135,9323,-188,-2.016518288
32525,3,äCémí¨,2354,2374,-20,-0.842459983,33.43,70.4,1054,1052,2,0.190114068
32526,3,êºÉmìáí¨,3028,3136,-108,-3.443877551,55.95,54.1,1504,1477,27,1.82802979
32527,3,ímïvë∫,615,657,-42,-6.392694064,13.7,44.9,331,326,5,1.533742331
32528,3,âBäÚÇÃìáí¨,14591,15521,-930,-5.991881966,242.83,60.1,6246,6468,-222,-3.432282004
33000,a,â™éRåß,1922181,1945276,-23095,-1.187235128,7114.62,270.2,772106,754511,17595,2.331973954
33001,b,ésïî,1806940,1824384,-17444,-0.956158353,5612.03,322,730452,712686,17766,2.492822926
33002,b,åSïî,115241,120892,-5651,-4.674420144,1502.59,76.7,41654,41825,-171,-0.408846384
33100,1,â™éRés,719584,709584,10000,1.409276421,789.96,910.9,309101,296790,12311,4.14805081
33101,0,â™éRés ñkãÊ,309496,302685,6811,2.250194096,450.7,686.7,145974,139204,6770,4.863365995
33102,0,â™éRés íÜãÊ,146265,142237,4028,2.831893249,51.25,2854,61501,58961,2540,4.307932362
33103,0,â™éRés ìåãÊ,95604,96948,-1344,-1.386310187,160.53,595.6,36137,35199,938,2.664848433
33104,0,â™éRés ìÏãÊ,168219,167714,505,0.301107838,127.48,1319.6,65489,63426,2063,3.25260934
33202,2,ëqï~és,477435,475513,1922,0.404195048,355.63,1342.5,189736,183303,6433,3.509489752
33203,2,í√éRés,103714,106788,-3074,-2.878600592,506.33,204.8,40304,39876,428,1.073327315
33204,2,ã ñÏés,60782,64588,-3806,-5.892735493,103.58,586.8,24736,25449,-713,-2.801681795
33205,2,ä}â™és,50593,54225,-3632,-6.69801752,136.39,370.9,19155,19676,-521,-2.647895914
33207,2,à‰å¥és,41419,43927,-2508,-5.709472534,243.54,170.1,14898,15108,-210,-1.389992057
33208,2,ëçé–és,66888,66201,687,1.037748675,211.9,315.7,24847,23459,1388,5.916705742
33209,2,çÇó¿és,32091,34963,-2872,-8.214398078,546.99,58.7,13416,14121,-705,-4.992564266
33210,2,êVå©és,30677,33870,-3193,-9.42722173,793.29,38.7,11667,12208,-541,-4.431520315
33211,2,îıëOés,35207,37839,-2632,-6.955786358,258.29,136.3,13826,14136,-310,-2.192982456
33212,2,ê£åÀì‡és,36983,37852,-869,-2.295783578,125.45,294.8,13646,13343,303,2.270853631
33213,2,ê‘î÷és,43218,43458,-240,-0.552257352,209.36,206.4,15704,15274,430,2.815241587
33214,2,ê^íÎés,46137,48964,-2827,-5.773629605,828.53,55.7,16079,16458,-379,-2.30283145
33215,2,î¸çÏés,27956,30498,-2542,-8.334972785,429.29,65.1,10885,11205,-320,-2.855867916
33216,2,êÛå˚és,34256,36114,-1858,-5.144819184,66.46,515.4,12452,12280,172,1.400651466
33340,c,òaãCåS,14410,15362,-952,-6.197109751,144.21,99.9,5211,5394,-183,-3.39265851
33346,3,òaãCí¨,14410,15362,-952,-6.197109751,144.21,99.9,5211,5394,-183,-3.39265851
33420,c,ìsåEåS,12159,12214,-55,-0.450302931,7.62,1595.7,4347,4200,147,3.5
33423,3,ëÅìáí¨,12159,12214,-55,-0.450302931,7.62,1595.7,4347,4200,147,3.5
33440,c,êÛå˚åS,10937,10916,21,0.192378161,12.23,894.3,4024,3795,229,6.0342556
33445,3,ó¢èØí¨,10937,10916,21,0.192378161,12.23,894.3,4024,3795,229,6.0342556
33460,c,è¨ìcåS,14213,15092,-879,-5.824277763,90.62,156.8,4954,4947,7,0.141499899
33461,3,ñÓä|í¨,14213,15092,-879,-5.824277763,90.62,156.8,4954,4947,7,0.141499899
33580,c,ê^íÎåS,866,957,-91,-9.508881923,67.11,12.9,330,342,-12,-3.50877193
33586,3,êVèØë∫,866,957,-91,-9.508881923,67.11,12.9,330,342,-12,-3.50877193
33600,c,ìœìcåS,12853,13580,-727,-5.353460972,419.68,30.6,4669,4725,-56,-1.185185185
33606,3,ãæñÏí¨,12853,13580,-727,-5.353460972,419.68,30.6,4669,4725,-56,-1.185185185
33620,c,èüìcåS,17016,17280,-264,-1.527777778,123.56,137.7,6028,5917,111,1.875950651
33622,3,èüâõí¨,11117,11195,-78,-0.696739616,54.05,205.7,4052,3928,124,3.156822811
33623,3,ìﬁã`í¨,5899,6085,-186,-3.056696795,69.52,84.9,1976,1989,-13,-0.653594771
33640,c,âpìcåS,1472,1520,-48,-3.157894737,57.97,25.4,561,557,4,0.718132855
33643,3,êºàæëqë∫,1472,1520,-48,-3.157894737,57.97,25.4,561,557,4,0.718132855
33660,c,ãvïƒåS,19360,20938,-1578,-7.536536441,310.81,62.3,7155,7488,-333,-4.447115385
33663,3,ãvïƒìÏí¨,4909,5296,-387,-7.307401813,78.65,62.4,1893,1957,-64,-3.270311702
33666,3,î¸çÁí¨,14451,15642,-1191,-7.614115842,232.17,62.2,5262,5531,-269,-4.863496655
33680,c,â¡âÍåS,11955,13033,-1078,-8.271311287,268.78,44.5,4375,4460,-85,-1.905829596
33681,3,ãgîıíÜâõí¨,11955,13033,-1078,-8.271311287,268.78,44.5,4375,4460,-85,-1.905829596
34000,a,çLìáåß,2844963,2860750,-15787,-0.551848292,8479.38,335.5,1209581,1184967,24614,2.077188647
34001,b,ésïî,2669750,2680467,-10717,-0.39981839,6714.41,397.6,1137624,1113736,23888,2.144852999
34002,b,åSïî,175213,180283,-5070,-2.812245192,1764.97,99.3,71957,71231,726,1.01921916
34100,1,çLìáés,1194507,1173843,20664,1.760371702,906.53,1317.7,531438,512907,18531,3.612935678
34101,0,çLìáés íÜãÊ,136684,130482,6202,4.753146028,15.32,8921.9,76858,73281,3577,4.881210682
34102,0,çLìáés ìåãÊ,120075,120751,-676,-0.559829732,39.42,3046,51673,50605,1068,2.110463393
34103,0,çLìáés ìÏãÊ,142719,138190,4529,3.277371735,26.3,5426.6,68792,66357,2435,3.669545037
34104,0,çLìáés êºãÊ,191134,186985,4149,2.218894564,35.61,5367.4,90498,87222,3276,3.755933136
34105,0,çLìáés à¿ç≤ìÏãÊ,242660,233733,8927,3.819315202,117.24,2069.8,99413,95188,4225,4.438584696
34106,0,çLìáés à¿ç≤ñkãÊ,145074,149633,-4559,-3.046787808,353.33,410.6,57128,56550,578,1.022104332
34107,0,çLìáés à¿å|ãÊ,79370,78789,581,0.737412583,94.08,843.6,31254,30310,944,3.114483669
34108,0,çLìáés ç≤îåãÊ,136791,135280,1511,1.116942638,225.22,607.4,55822,53394,2428,4.547327415
34202,2,å‡és,228635,239973,-11338,-4.724698195,352.8,648.1,96815,98654,-1839,-1.86409066
34203,2,í|å¥és,26440,28644,-2204,-7.694456082,118.23,223.6,11197,11525,-328,-2.845986985
34204,2,éOå¥és,96205,100509,-4304,-4.282203584,471.54,204,39629,40247,-618,-1.535518175
34205,2,îˆìπés,138628,145202,-6574,-4.527485847,285.09,486.3,57710,58772,-1062,-1.806982917
34207,2,ïüéRés,465004,461357,3647,0.790494129,518.05,897.6,185122,178718,6404,3.583298828
34208,2,ï{íÜés,40084,42563,-2479,-5.824307497,195.75,204.8,14920,15122,-202,-1.335802143
34209,2,éOéüés,53677,56605,-2928,-5.172687925,778.14,69,21343,21786,-443,-2.033415955
34210,2,èØå¥és,37008,40244,-3236,-8.040950204,1246.49,29.7,14496,15269,-773,-5.062545026
34211,2,ëÂí|és,27884,28836,-952,-3.30142877,78.66,354.5,11738,11851,-113,-0.953506033
34212,2,ìåçLìáés,192905,190135,2770,1.4568596,635.16,303.7,84804,80986,3818,4.714395081
34213,2,ì˘ì˙ésés,114937,114038,899,0.788333713,489.48,234.8,46008,44644,1364,3.055281785
34214,2,à¿å|çÇìcés,29485,31487,-2002,-6.358179566,537.75,54.8,11659,11804,-145,-1.228397154
34215,2,ç]ìcìáés,24351,27031,-2680,-9.914542562,100.74,241.7,10745,11451,-706,-6.165400402
34300,c,à¿å|åS,116237,116712,-475,-0.406984715,73.66,1578,47778,46378,1400,3.018672647
34302,3,ï{íÜí¨,51055,50442,613,1.215257127,10.41,4904.4,21092,20237,855,4.224934526
34304,3,äCìcí¨,28665,28475,190,0.667251975,13.79,2078.7,12199,11667,532,4.559869718
34307,3,åFñÏí¨,23762,24533,-771,-3.142705743,33.76,703.9,9386,9291,95,1.022494888
34309,3,ç‚í¨,12755,13262,-507,-3.822952798,15.69,812.9,5101,5183,-82,-1.582095312
34360,c,éRåßåS,25375,27224,-1849,-6.791801352,988.09,25.7,10512,10716,-204,-1.903695409
34368,3,à¿å|ëæìcí¨,6460,7255,-795,-10.95796003,341.89,18.9,2774,3017,-243,-8.054358634
34369,3,ñkçLìáí¨,18915,19969,-1054,-5.278181181,646.2,29.3,7738,7699,39,0.506559293
34420,c,ñLìcåS,8037,8448,-411,-4.865056818,43.11,186.4,3890,3880,10,0.257731959
34431,3,ëÂçËè„ìáí¨,8037,8448,-411,-4.865056818,43.11,186.4,3890,3880,10,0.257731959
34460,c,ê¢óÖåS,16340,17549,-1209,-6.889281441,278.14,58.7,6239,6504,-265,-4.074415744
34462,3,ê¢óÖí¨,16340,17549,-1209,-6.889281441,278.14,58.7,6239,6504,-265,-4.074415744
34540,c,ê_êŒåS,9224,10350,-1126,-10.87922705,381.98,24.1,3538,3753,-215,-5.728750333
34545,3,ê_êŒçÇå¥í¨,9224,10350,-1126,-10.87922705,381.98,24.1,3538,3753,-215,-5.728750333
35000,a,éRå˚åß,1405007,1451338,-46331,-3.192295661,6112.3,229.9,598550,597432,1118,0.187134268
35001,b,ésïî,1347116,1389324,-42208,-3.038024248,5727.99,235.2,573912,571651,2261,0.395521043
35002,b,åSïî,57891,62014,-4123,-6.648498726,384.3,150.6,24638,25781,-1143,-4.433497537
35201,2,â∫ä÷és,268617,280947,-12330,-4.388728123,715.89,375.2,116301,118178,-1877,-1.588282083
35202,2,âFïîés,169410,173772,-4362,-2.510185761,286.65,591,73225,72447,778,1.073888498
35203,2,éRå˚és,197502,196628,874,0.444494172,1023.23,193,84980,81299,3681,4.527730968
35204,2,îãés,49571,53747,-4176,-7.769735985,698.31,71,21601,22243,-642,-2.886301308
35206,2,ñhï{és,115981,116611,-630,-0.54025778,189.37,612.5,47571,46851,720,1.536786835
35207,2,â∫èºés,55831,55012,819,1.488766087,89.35,624.9,23726,22653,1073,4.736679469
35208,2,ä‚çëés,136809,143857,-7048,-4.899309731,873.72,156.6,59001,59486,-485,-0.81531789
35210,2,åıés,51392,53004,-1612,-3.041279903,92.13,557.8,20872,20913,-41,-0.196050304
35211,2,í∑ñÂés,35452,38349,-2897,-7.554303893,357.29,99.2,14661,15143,-482,-3.18298884
35212,2,ñˆà‰és,32966,34730,-1764,-5.079182263,140.05,235.4,14170,14527,-357,-2.457492944
35213,2,î¸îIés,26166,28630,-2464,-8.606356968,472.64,55.4,10093,10534,-441,-4.186443896
35215,2,é¸ìÏés,144713,149487,-4774,-3.19358874,656.29,220.5,61975,61841,134,0.216684724
35216,2,éRózè¨ñÏìcés,62706,64550,-1844,-2.856700232,133.09,471.2,25736,25536,200,0.78320802
35300,c,ëÂìáåS,17203,19084,-1881,-9.85642423,138.09,124.6,8040,8786,-746,-8.490780788
35305,3,é¸ñhëÂìáí¨,17203,19084,-1881,-9.85642423,138.09,124.6,8040,8786,-746,-8.490780788
35320,c,ãËâœåS,6288,6378,-90,-1.411100659,10.58,594.3,2594,2589,5,0.193124759
35321,3,òañÿí¨,6288,6378,-90,-1.411100659,10.58,594.3,2594,2589,5,0.193124759
35340,c,åFñ—åS,30931,32809,-1878,-5.724039136,119.69,258.4,12509,12827,-318,-2.479145552
35341,3,è„ä÷í¨,2804,3332,-528,-15.84633854,34.69,80.8,1459,1668,-209,-12.52997602
35343,3,ìcïzé{í¨,15325,15986,-661,-4.13486801,50.42,303.9,6105,6115,-10,-0.163532298
35344,3,ïΩê∂í¨,12802,13491,-689,-5.107108443,34.58,370.2,4945,5044,-99,-1.962727994
35500,c,à¢ïêåS,3469,3743,-274,-7.320331285,115.95,29.9,1495,1579,-84,-5.319822673
35502,3,à¢ïêí¨,3469,3743,-274,-7.320331285,115.95,29.9,1495,1579,-84,-5.319822673
36000,a,ìøìáåß,756063,785491,-29428,-3.74644649,4146.93,182.3,305098,302294,2804,0.927573819
36001,b,ésïî,565686,588440,-22754,-3.866834342,2075.64,272.5,231609,229517,2092,0.911479324
36002,b,åSïî,190377,197051,-6674,-3.386940437,2071.29,91.9,73489,72777,712,0.978331066
36201,2,ìøìáés,258602,264548,-5946,-2.24760724,191.25,1352.2,114352,111675,2677,2.397134542
36202,2,ñ¬ñÂés,59122,61513,-2391,-3.886983239,135.66,435.8,23233,22994,239,1.039401583
36203,2,è¨èºìáés,38776,40614,-1838,-4.525533067,45.37,854.7,15235,15201,34,0.223669495
36204,2,à¢ìÏés,73100,76063,-2963,-3.895455083,279.56,261.5,27208,26910,298,1.10739502
36205,2,ãgñÏêÏés,41487,44020,-2533,-5.754202635,144.14,287.8,15711,15794,-83,-0.525516019
36206,2,à¢îgés,37218,39247,-2029,-5.169821897,191.11,194.7,13101,13252,-151,-1.139450649
36207,2,î¸înés,30530,32484,-1954,-6.015269056,367.14,83.2,11463,11648,-185,-1.588255495
36208,2,éOçDés,26851,29951,-3100,-10.35023872,721.42,37.2,11306,12043,-737,-6.119737607
36300,c,èüâYåS,6849,7548,-699,-9.26073132,179.46,38.2,2592,2644,-52,-1.966717095
36301,3,èüâYí¨,5303,5765,-462,-8.013876843,69.83,75.9,1860,1881,-21,-1.116427432
36302,3,è„èüí¨,1546,1783,-237,-13.29220415,109.63,14.1,732,763,-31,-4.062909568
36320,c,ñºìååS,2292,2588,-296,-11.4374034,42.28,54.2,793,834,-41,-4.916067146
36321,3,ç≤ìﬂâÕì‡ë∫,2292,2588,-296,-11.4374034,42.28,54.2,793,834,-41,-4.916067146
36340,c,ñºêºåS,30905,31992,-1087,-3.397724431,202.16,152.9,11488,11284,204,1.80786955
36341,3,êŒà‰í¨,25600,25954,-354,-1.363951607,28.85,887.3,9330,8933,397,4.444195679
36342,3,ê_éRí¨,5305,6038,-733,-12.13978138,173.3,30.6,2158,2351,-193,-8.20927265
36360,c,ìﬂâÍåS,8407,9318,-911,-9.776776132,694.98,12.1,3489,3708,-219,-5.906148867
36368,3,ìﬂâÍí¨,8407,9318,-911,-9.776776132,694.98,12.1,3489,3708,-219,-5.906148867
36380,c,äCïîåS,20646,23037,-2391,-10.37895559,525.03,39.3,8957,9626,-669,-6.94992728
36383,3,ñ¥äÚí¨,4260,4826,-566,-11.72813925,56.56,75.3,1871,2059,-188,-9.130645945
36387,3,î¸îgí¨,7101,7765,-664,-8.551191243,140.82,50.4,2889,3097,-208,-6.716176945
36388,3,äCózí¨,9285,10446,-1161,-11.11430213,327.65,28.3,4197,4470,-273,-6.10738255
36400,c,î¬ñÏåS,97697,97034,663,0.68326566,110.06,887.7,37011,35115,1896,5.399401965
36401,3,èºñŒí¨,15212,15070,142,0.942269409,14.24,1068.3,5887,5602,285,5.087468761
36402,3,ñkìáí¨,22445,21658,787,3.633761197,8.74,2568.1,8811,8269,542,6.554601524
36403,3,óïèZí¨,34629,33338,1291,3.872457856,16.27,2128.4,13123,12098,1025,8.472474789
36404,3,î¬ñÏí¨,13369,14241,-872,-6.123165508,36.22,369.1,4927,4897,30,0.612619971
36405,3,è„î¬í¨,12042,12727,-685,-5.382258191,34.58,348.2,4263,4249,14,0.329489292
36460,c,î¸înåS,8930,10490,-1560,-14.87130601,194.84,45.8,3839,4286,-447,-10.42930471
36468,3,Ç¬ÇÈÇ¨í¨,8930,10490,-1560,-14.87130601,194.84,45.8,3839,4286,-447,-10.42930471
36480,c,éOçDåS,14651,15044,-393,-2.612337144,122.48,119.6,5320,5280,40,0.757575758
36489,3,ìåÇ›ÇÊÇµí¨,14651,15044,-393,-2.612337144,122.48,119.6,5320,5280,40,0.757575758
37000,a,çÅêÏåß,976756,995842,-19086,-1.916569094,1876.73,520.5,398316,390474,7842,2.008328339
37001,b,ésïî,823501,837167,-13666,-1.63241026,1271.63,647.6,336989,329441,7548,2.291153803
37002,b,åSïî,153255,158675,-5420,-3.415786986,605.11,253.3,61327,61033,294,0.481706618
37201,2,çÇèºés,420943,419429,1514,0.360966934,375.41,1121.3,182005,174278,7727,4.433720837
37202,2,ä€ãTés,110063,110473,-410,-0.371131408,111.78,984.6,43816,42983,833,1.937975479
37203,2,ç‚èoés,53197,55621,-2424,-4.358066198,92.51,575,21356,21394,-38,-0.177619893
37204,2,ëPí éõés,32942,33817,-875,-2.587456013,39.93,825,12976,12987,-11,-0.084700085
37205,2,äœâπéõés,59444,62690,-3246,-5.177859308,117.84,504.4,21909,22476,-567,-2.52269087
37206,2,Ç≥Ç Ç´és,50300,53000,-2700,-5.094339623,158.63,317.1,19737,19698,39,0.197989644
37207,2,ìåÇ©Ç™ÇÌés,31046,33625,-2579,-7.669888476,152.83,203.1,12438,12754,-316,-2.477654069
37208,2,éOñLés,65566,68512,-2946,-4.299976646,222.71,294.4,22752,22871,-119,-0.520309562
37320,c,è¨ì§åS,28875,31275,-2400,-7.673860911,169.96,169.9,12473,13013,-540,-4.149696457
37322,3,ìyèØí¨,14005,15123,-1118,-7.392713086,74.37,188.3,6059,6297,-238,-3.779577577
37324,3,è¨ì§ìáí¨,14870,16152,-1282,-7.937097573,95.59,155.6,6414,6716,-302,-4.496724241
37340,c,ñÿìcåS,27695,28464,-769,-2.701658235,75.78,365.5,10658,10639,19,0.178588213
37341,3,éOñÿí¨,27695,28464,-769,-2.701658235,75.78,365.5,10658,10639,19,0.178588213
37360,c,çÅêÏåS,3142,3325,-183,-5.503759399,14.22,221,1516,1510,6,0.397350993
37364,3,íºìáí¨,3142,3325,-183,-5.503759399,14.22,221,1516,1510,6,0.397350993
37380,c,àªâÃåS,42580,43059,-479,-1.112427135,117.84,361.3,17012,16459,553,3.359863904
37386,3,âFëΩí√í¨,18958,18434,524,2.842573506,8.1,2340.5,8464,8050,414,5.142857143
37387,3,àªêÏí¨,23622,24625,-1003,-4.073096447,109.75,215.2,8548,8409,139,1.652990843
37400,c,íáëΩìxåS,50963,52552,-1589,-3.023671792,227.3,224.2,19668,19412,256,1.318771894
37403,3,ã’ïΩí¨,9189,9967,-778,-7.805759005,8.47,1084.9,3708,3880,-172,-4.432989691
37404,3,ëΩìxí√í¨,23382,23498,-116,-0.493659035,24.38,959.1,9508,9177,331,3.606843195
37406,3,Ç‹ÇÒÇÃÇ§í¨,18392,19087,-695,-3.641221774,194.45,94.6,6452,6355,97,1.526357199
38000,a,à§ïQåß,1385840,1431493,-45653,-3.189187792,5676.1,244.2,592209,590888,1321,0.223561826
38001,b,ésïî,1255878,1292863,-36985,-2.860705272,3967.31,316.6,538140,535230,2910,0.543691497
38002,b,åSïî,129962,138630,-8668,-6.252614874,1708.79,76.1,54069,55658,-1589,-2.854935499
38201,2,èºéRés,515092,517231,-2139,-0.413548299,429.37,1199.6,230816,224178,6638,2.961039888
38202,2,ç°é°és,158185,166532,-8347,-5.012249898,419.13,377.4,66980,68249,-1269,-1.859367903
38203,2,âFòaìáés,77473,84210,-6737,-8.000237502,468.15,165.5,32706,34041,-1335,-3.92174143
38204,2,î™î¶ïlés,34963,38370,-3407,-8.879332812,132.68,263.5,14993,15849,-856,-5.40097167
38205,2,êVãèïlés,119905,121735,-1830,-1.503265289,234.46,511.4,50638,50377,261,0.518093574
38206,2,êºèés,108244,112091,-3847,-3.432032902,509.98,212.3,44592,44630,-38,-0.085144522
38207,2,ëÂèFés,44131,47157,-3026,-6.41686282,432.22,102.1,18085,18410,-325,-1.765344921
38210,2,à…ó\és,36839,38017,-1178,-3.098613778,194.44,189.5,14026,13959,67,0.479977076
38213,2,élçëíÜâõés,87467,90187,-2720,-3.015955736,421.24,207.6,34954,34951,3,0.008583445
38214,2,êºó\és,38927,42080,-3153,-7.492870722,514.34,75.7,16370,17096,-726,-4.246607394
38215,2,ìåâ∑és,34652,35253,-601,-1.704819448,211.3,164,13980,13490,490,3.632320237
38340,c,âzíqåS,7122,7648,-526,-6.877615063,30.38,234.4,3386,3618,-232,-6.412382532
38356,3,è„ìáí¨,7122,7648,-526,-6.877615063,30.38,234.4,3386,3618,-232,-6.412382532
38380,c,è„ïÇåäåS,8460,9644,-1184,-12.27706346,583.69,14.5,4060,4468,-408,-9.131602507
38386,3,ãvñúçÇå¥í¨,8460,9644,-1184,-12.27706346,583.69,14.5,4060,4468,-408,-9.131602507
38400,c,à…ó\åS,51322,52340,-1018,-1.944975162,121.99,420.7,19878,19580,298,1.521961185
38401,3,èºëOí¨,30070,30359,-289,-0.951941764,20.41,1473.3,11524,11308,216,1.910152105
38402,3,ìuïîí¨,21252,21981,-729,-3.316500614,101.59,209.2,8354,8272,82,0.991295938
38420,c,äÏëΩåS,16750,18045,-1295,-7.176503187,299.43,55.9,6475,6722,-247,-3.674501636
38422,3,ì‡éqí¨,16750,18045,-1295,-7.176503187,299.43,55.9,6475,6722,-247,-3.674501636
38440,c,êºâFòaåS,9629,10882,-1253,-11.51442749,93.98,102.5,4486,4884,-398,-8.149058149
38442,3,à…ï˚í¨,9629,10882,-1253,-11.51442749,93.98,102.5,4486,4884,-398,-8.149058149
38480,c,ñkâFòaåS,14776,16010,-1234,-7.707682698,340.34,43.4,6373,6549,-176,-2.687433196
38484,3,èºñÏí¨,4068,4377,-309,-7.059629884,98.45,41.3,1773,1748,25,1.43020595
38488,3,ãSñkí¨,10708,11633,-925,-7.951517236,241.88,44.3,4600,4801,-201,-4.186627786
38500,c,ìÏâFòaåS,21903,24061,-2158,-8.968870787,238.98,91.7,9411,9837,-426,-4.330588594
38506,3,à§ìÏí¨,21903,24061,-2158,-8.968870787,238.98,91.7,9411,9837,-426,-4.330588594
39000,a,çÇímåß,728461,764456,-35995,-4.70857708,7103.91,102.5,318972,321909,-2937,-0.912369645
39001,b,ésïî,595681,618174,-22493,-3.638619547,3075.76,193.7,261801,261633,168,0.064212083
39002,b,åSïî,132780,146282,-13502,-9.230117171,4028.15,33,57171,60276,-3105,-5.151304002
39201,2,çÇímés,337360,343393,-6033,-1.756879144,308.99,1091.8,153676,150857,2819,1.868657073
39202,2,é∫åÀés,13523,15210,-1687,-11.09138725,248.18,54.5,6514,6996,-482,-6.889651229
39203,2,à¿å|és,17602,19547,-1945,-9.950376017,317.2,55.5,7608,8111,-503,-6.201454814
39204,2,ìÏçëés,47999,49472,-1473,-2.977441785,125.3,383.1,19496,19377,119,0.614130154
39205,2,ìyç≤és,27065,28686,-1621,-5.650840131,91.49,295.8,10248,10544,-296,-2.807283763
39206,2,ê{çËés,22598,24698,-2100,-8.50271277,135.44,166.8,9011,9323,-312,-3.346562265
39208,2,èhñ—és,20919,22610,-1691,-7.478991597,286.19,73.1,8917,9213,-296,-3.212851406
39209,2,ìyç≤ê¥êÖés,13780,16029,-2249,-14.03081914,266.34,51.7,6588,7216,-628,-8.702882483
39210,2,élñúè\és,34315,35933,-1618,-4.502824702,632.29,54.3,14795,14874,-79,-0.531128143
39211,2,çÅìÏés,32979,33830,-851,-2.51551877,126.48,260.7,12954,12877,77,0.597965365
39212,2,çÅî¸és,27541,28766,-1225,-4.258499618,537.86,51.2,11994,12245,-251,-2.049816252
39300,c,à¿å|åS,17204,18819,-1615,-8.581752484,563.13,30.6,7620,7896,-276,-3.49544073
39301,3,ìåómí¨,2583,2947,-364,-12.35154394,74.06,34.9,1382,1461,-79,-5.407255305
39302,3,ìﬁîºóòí¨,3285,3542,-257,-7.255787691,28.36,115.8,1447,1480,-33,-2.22972973
39303,3,ìcñÏí¨,2734,2932,-198,-6.753069577,6.53,418.7,1185,1214,-29,-2.388797364
39304,3,à¿ìcí¨,2636,2970,-334,-11.24579125,52.36,50.3,1146,1203,-57,-4.738154614
39305,3,ñkêÏë∫,1294,1367,-73,-5.340160936,196.73,6.6,582,598,-16,-2.675585284
39306,3,înòHë∫,822,1013,-191,-18.85488648,165.48,5,391,450,-59,-13.11111111
39307,3,å|êºë∫,3850,4048,-198,-4.891304348,39.6,97.2,1487,1490,-3,-0.201342282
39340,c,í∑â™åS,7545,8822,-1277,-14.4751757,449.28,16.8,3749,4070,-321,-7.886977887
39341,3,ñ{éRí¨,3579,4103,-524,-12.77114307,134.22,26.7,1698,1758,-60,-3.412969283
39344,3,ëÂñLí¨,3966,4719,-753,-15.9567705,315.06,12.6,2051,2312,-261,-11.28892734
39360,c,ìyç≤åS,4396,4769,-373,-7.821346194,307.4,14.3,1945,2012,-67,-3.330019881
39363,3,ìyç≤í¨,3999,4358,-359,-8.237723727,212.13,18.9,1734,1799,-65,-3.613118399
39364,3,ëÂêÏë∫,397,411,-14,-3.406326034,95.27,4.2,211,213,-2,-0.938967136
39380,c,å·êÏåS,28278,31562,-3284,-10.40491731,803.97,35.2,11934,12846,-912,-7.099486221
39386,3,Ç¢ÇÃí¨,22735,25062,-2327,-9.284973266,470.97,48.3,9189,9772,-583,-5.966025379
39387,3,êmóÑêÏí¨,5543,6500,-957,-14.72307692,333,16.6,2745,3074,-329,-10.70266753
39400,c,çÇâ™åS,57468,62480,-5012,-8.021766965,1527.48,37.6,23951,25082,-1131,-4.509209792
39401,3,íÜìyç≤í¨,6807,7605,-798,-10.49309665,193.28,35.2,2918,3121,-203,-6.504325537
39402,3,ç≤êÏí¨,13114,13951,-837,-5.999569923,100.8,130.1,5236,5340,-104,-1.947565543
39403,3,âzímí¨,5797,6374,-577,-9.052400377,111.95,51.8,2518,2641,-123,-4.65732677
39405,3,ûçå¥í¨,3608,3984,-376,-9.437751004,236.45,15.3,1560,1769,-209,-11.81458451
39410,3,ì˙çÇë∫,5026,5447,-421,-7.729025152,44.85,112.1,1976,2063,-87,-4.217159477
39411,3,í√ñÏí¨,5796,6407,-611,-9.536444514,197.85,29.3,2297,2406,-109,-4.530340815
39412,3,élñúè\í¨,17320,18712,-1392,-7.439076528,642.3,27,7446,7742,-296,-3.823301473
39420,c,î¶ëΩåS,17889,19830,-1941,-9.788199697,376.9,47.5,7972,8370,-398,-4.755077658
39424,3,ëÂåéí¨,5100,5783,-683,-11.81047899,102.94,49.5,2370,2573,-203,-7.889623008
39427,3,éOå¥ë∫,1568,1681,-113,-6.722189173,85.37,18.4,702,745,-43,-5.771812081
39428,3,çïí™í¨,11221,12366,-1145,-9.259259259,188.58,59.5,4900,5052,-152,-3.008709422
40000,a,ïüâ™åß,5102871,5071968,30903,0.609290122,4986.4,1023.4,2199429,2110468,88961,4.215226196
40001,b,ésïî,4449527,4414217,35310,0.799915364,3688.03,1206.5,1951574,1868530,83044,4.444349301
40002,b,åSïî,653344,657751,-4407,-0.670010384,1298.36,503.2,247855,241938,5917,2.445667898
40100,1,ñkã„èBés,961815,976846,-15031,-1.538727701,491.95,1955.1,426277,420702,5575,1.325166032
40101,0,ñkã„èBés ñÂéiãÊ,99677,104469,-4792,-4.587006672,73.67,1353,43078,44232,-1154,-2.608970881
40103,0,ñkã„èBés é·èºãÊ,82881,85167,-2286,-2.684138223,71.31,1162.3,33686,33495,191,0.570234363
40105,0,ñkã„èBés åÀî®ãÊ,59137,61583,-2446,-3.971875355,16.61,3560.3,27827,28064,-237,-0.84449829
40106,0,ñkã„èBés è¨ëqñkãÊ,182007,181936,71,0.039024712,39.23,4639.5,91173,89036,2137,2.400152747
40107,0,ñkã„èBés è¨ëqìÏãÊ,212933,214793,-1860,-0.865950008,171.74,1239.9,88487,86420,2067,2.391807452
40108,0,ñkã„èBés î™î¶ìåãÊ,68891,71801,-2910,-4.052868345,36.26,1899.9,31543,32142,-599,-1.863605252
40109,0,ñkã„èBés î™î¶êºãÊ,256289,257097,-808,-0.314278269,83.13,3083,110483,107313,3170,2.953975753
40130,1,ïüâ™és,1538510,1463743,74767,5.107932199,343.38,4480.5,764159,707358,56801,8.030021573
40131,0,ïüâ™és ìåãÊ,306014,292199,13815,4.727942259,69.36,4412,140887,133165,7722,5.798821012
40132,0,ïüâ™és îéëΩãÊ,228200,212527,15673,7.374592405,31.62,7217,139070,124266,14804,11.91315404
40133,0,ïüâ™és íÜâõãÊ,192554,178429,14125,7.916314052,15.39,12511.6,115966,106966,9000,8.413888525
40134,0,ïüâ™és ìÏãÊ,255852,247096,8756,3.543562016,30.98,8258.6,119589,112423,7166,6.374140523
40135,0,ïüâ™és êºãÊ,206974,193280,13694,7.085057947,84.16,2459.3,88362,78018,10344,13.25847881
40136,0,ïüâ™és èÈìÏãÊ,130973,128659,2314,1.798552764,15.99,8190.9,64590,62266,2324,3.732374008
40137,0,ïüâ™és ëÅó«ãÊ,217943,211553,6390,3.020519681,95.87,2273.3,95695,90254,5441,6.028541671
40202,2,ëÂñ¥ìcés,117413,123638,-6225,-5.034859833,81.45,1441.5,49363,49936,-573,-1.14746876
40203,2,ãvóØïƒés,304499,302402,2097,0.693447795,229.96,1324.1,121742,116664,5078,4.352670918
40204,2,íºï˚és,57180,57686,-506,-0.87716257,61.76,925.8,23202,22645,557,2.459704129
40205,2,î—íÀés,129246,131492,-2246,-1.708088705,214.07,603.8,54719,53451,1268,2.372266188
40206,2,ìcêÏés,48461,50605,-2144,-4.2367355,54.55,888.4,20909,21198,-289,-1.363336164
40207,2,ñˆêÏés,67829,71375,-3546,-4.968126095,77.15,879.2,23436,23333,103,0.441434878
40210,2,î™èóés,64437,69057,-4620,-6.690125549,482.44,133.6,22130,22316,-186,-0.833482703
40211,2,í}å„és,48350,48512,-162,-0.333937995,41.78,1157.3,17341,16628,713,4.28794804
40212,2,ëÂêÏés,34839,37448,-2609,-6.966994232,33.62,1036.3,12688,12577,111,0.882563409
40213,2,çsã¥és,70601,70468,133,0.188738151,70.05,1007.9,28653,27634,1019,3.68748643
40214,2,ñLëOés,25961,27031,-1070,-3.958418113,111.1,233.7,10086,10095,-9,-0.089153046
40215,2,íÜä‘és,41808,44210,-2402,-5.433159919,15.96,2619.5,17415,17801,-386,-2.168417505
40216,2,è¨åSés,58009,58499,-490,-0.837621156,45.51,1274.6,20901,20024,877,4.379744307
40217,2,í}éáñÏés,101122,100172,950,0.948368806,87.73,1152.7,39338,37703,1635,4.336524945
40218,2,ètì˙és,110767,106780,3987,3.733845289,14.15,7828.1,43706,41075,2631,6.405356056
40219,2,ëÂñÏèÈés,99575,95087,4488,4.719888103,26.89,3703,39840,36778,3062,8.325629452
40220,2,è@ëúés,96566,95501,1065,1.115171569,119.91,805.3,39002,37077,1925,5.191897942
40221,2,ëæç…ï{és,72200,70482,1718,2.437501774,29.6,2439.2,29103,27850,1253,4.499102334
40223,2,å√âÍés,57953,57920,33,0.056975138,42.07,1377.5,22321,21517,804,3.736580378
40224,2,ïüí√és,58808,55431,3377,6.092258844,52.76,1114.6,22250,20482,1768,8.631969534
40225,2,Ç§Ç´ÇÕés,29540,31640,-2100,-6.637168142,117.46,251.5,9937,10219,-282,-2.759565515
40226,2,ã{é·és,28104,30081,-1977,-6.572254912,139.99,200.8,10713,11094,-381,-3.434288805
40227,2,â√ñÉés,38780,42589,-3809,-8.943623941,135.11,287,15677,16472,-795,-4.826372025
40228,2,í©ëqés,52459,56355,-3896,-6.913317363,246.71,212.6,19066,19064,2,0.010490978
40229,2,Ç›Ç‚Ç‹és,38163,40732,-2569,-6.307080428,105.21,362.7,12936,13072,-136,-1.040391677
40230,2,éÖìáés,96532,98435,-1903,-1.933255448,215.7,447.5,34664,33765,899,2.662520361
40300,c,í}éáåS,50029,49780,249,0.500200884,74.95,667.5,18138,17619,519,2.945683637
40305,3,ìﬂâœêÏí¨,50029,49780,249,0.500200884,74.95,667.5,18138,17619,519,2.945683637
40340,c,ëåâÆåS,225643,214567,11076,5.162023983,164.64,1370.5,83932,77375,6557,8.474313409
40341,3,âFî¸í¨,37941,38592,-651,-1.68687811,30.21,1255.9,13109,12867,242,1.880780291
40342,3,é¬åIí¨,31212,31318,-106,-0.338463503,38.93,801.7,11537,11060,477,4.31283906
40343,3,éuñ∆í¨,45275,43564,1711,3.927554862,8.69,5210,17593,16617,976,5.873503039
40344,3,ê{åbí¨,27274,26044,1230,4.722776839,16.31,1672.2,9909,9077,832,9.166024017
40345,3,êVã{í¨,30339,24679,5660,22.93447871,18.93,1602.7,10944,8865,2079,23.45177665
40348,3,ãvéRí¨,8231,8373,-142,-1.695927386,37.44,219.8,2824,2657,167,6.285284155
40349,3,îîâÆí¨,45371,41997,3374,8.033907184,14.13,3211,18016,16232,1784,10.99063578
40380,c,âìâÍåS,93634,96669,-3035,-3.13957939,93.41,1002.4,36854,36690,164,0.44698828
40381,3,à∞âÆí¨,14199,15369,-1170,-7.612726918,11.6,1224.1,5577,5891,-314,-5.330164658
40382,3,êÖä™í¨,29001,30021,-1020,-3.397621665,11.01,2634.1,12226,12087,139,1.149995863
40383,3,â™ä_í¨,31587,32119,-532,-1.656340484,48.64,649.4,11794,11656,138,1.183939602
40384,3,âìâÍí¨,18847,19160,-313,-1.633611691,22.15,850.9,7257,7056,201,2.848639456
40400,c,à∆éËåS,23844,25690,-1846,-7.18567536,49.78,479,9725,10021,-296,-2.953797026
40401,3,è¨í|í¨,7815,8602,-787,-9.149035108,14.18,551.1,3333,3511,-178,-5.069780689
40402,3,à∆éËí¨,16029,17088,-1059,-6.197331461,35.6,450.3,6392,6510,-118,-1.812596006
40420,c,â√ï‰åS,13509,13863,-354,-2.553559836,20.14,670.8,5217,5216,1,0.019171779
40421,3,åjêÏí¨,13509,13863,-354,-2.553559836,20.14,670.8,5217,5216,1,0.019171779
40440,c,í©ëqåS,31506,31587,-81,-0.256434609,119.06,264.6,10518,10095,423,4.190193165
40447,3,í}ëOí¨,29332,29155,177,0.607099983,67.1,437.1,9756,9297,459,4.937076476
40448,3,ìåïÙë∫,2174,2432,-258,-10.60855263,51.97,41.8,762,798,-36,-4.511278196
40500,c,éOà‰åS,15155,15284,-129,-0.84401989,22.84,663.5,4934,4793,141,2.941790111
40503,3,ëÂìÅêÙí¨,15155,15284,-129,-0.84401989,22.84,663.5,4934,4793,141,2.941790111
40520,c,éO‡kåS,14181,14350,-169,-1.177700348,18.44,769,4551,4470,81,1.812080537
40522,3,ëÂñÿí¨,14181,14350,-169,-1.177700348,18.44,769,4551,4470,81,1.812080537
40540,c,î™èóåS,20194,20253,-59,-0.291314867,37.94,532.3,6994,6799,195,2.868068834
40544,3,çLêÏí¨,20194,20253,-59,-0.291314867,37.94,532.3,6994,6799,195,2.868068834
40600,c,ìcêÏåS,77713,83943,-6230,-7.421702822,309.18,251.4,31498,32665,-1167,-3.572631257
40601,3,çÅètí¨,10866,11685,-819,-7.008985879,44.5,244.2,4428,4595,-167,-3.634385201
40602,3,ìYìcí¨,9923,10909,-986,-9.038408653,132.2,75.1,4029,4215,-186,-4.412811388
40604,3,éÖìcí¨,9026,9617,-591,-6.145367578,8.04,1122.6,3805,3924,-119,-3.032619776
40605,3,êÏçËí¨,16801,18264,-1463,-8.010293474,36.14,464.9,7344,7693,-349,-4.536591707
40608,3,ëÂîCí¨,5183,5503,-320,-5.815009995,14.26,363.5,2052,2083,-31,-1.488238118
40609,3,ê‘ë∫,3028,3251,-223,-6.859427868,31.98,94.7,1122,1157,-35,-3.025064823
40610,3,ïüíqí¨,22886,24714,-1828,-7.396617302,42.06,544.1,8718,8998,-280,-3.111802623
40620,c,ãûìsåS,55248,57577,-2329,-4.045017976,200.22,275.9,22869,23263,-394,-1.693676654
40621,3,ä°ìcí¨,34984,36005,-1021,-2.835717262,48.88,715.7,15341,15560,-219,-1.407455013
40625,3,Ç›Ç‚Ç±í¨,20264,21572,-1308,-6.063415539,151.34,133.9,7528,7703,-175,-2.271842139
40640,c,ízè„åS,32688,34188,-1500,-4.387504388,187.78,174.1,12625,12932,-307,-2.373956078
40642,3,ãgïxí¨,6629,6792,-163,-2.399882214,5.73,1156.9,2588,2645,-57,-2.155009452
40646,3,è„ñ—í¨,7460,7852,-392,-4.992358635,62.44,119.5,2786,2843,-57,-2.004924376
40647,3,ízè„í¨,18599,19544,-945,-4.835243553,119.61,155.5,7251,7444,-193,-2.592692101
41000,a,ç≤âÍåß,833245,849788,-16543,-1.946720829,2440.64,341.4,301840,295038,6802,2.305465737
41001,b,ésïî,689549,700506,-10957,-1.564155054,1998.2,345.1,253008,247108,5900,2.387619988
41002,b,åSïî,143696,149282,-5586,-3.741911282,442.44,324.8,48832,47930,902,1.88191112
41201,2,ç≤âÍés,236398,237506,-1108,-0.46651453,431.84,547.4,93117,90435,2682,2.965665948
41202,2,ìÇí√és,122859,126926,-4067,-3.204229236,487.54,252,43836,43651,185,0.423816178
41203,2,íπê≤és,72910,69074,3836,5.553464401,71.72,1016.6,27580,25219,2361,9.361988977
41204,2,ëΩãvés,19742,21404,-1662,-7.764903756,96.96,203.6,6832,7100,-268,-3.774647887
41205,2,à…ñúó¢és,55294,57161,-1867,-3.266212977,255.28,216.6,19695,19614,81,0.412970327
41206,2,ïêóYés,49108,50699,-1591,-3.138128957,195.4,251.3,16932,16674,258,1.54731918
41207,2,é≠ìáés,29700,30720,-1020,-3.3203125,112.12,264.9,10117,10055,62,0.616608652
41208,2,è¨èÈés,44308,45133,-825,-1.827930782,95.81,462.5,14755,14305,450,3.145753233
41209,2,äñÏés,27359,28984,-1625,-5.60654154,126.41,216.4,9211,9314,-103,-1.105862143
41210,2,ê_çÈés,31871,32899,-1028,-3.124715037,125.13,254.7,10933,10741,192,1.787543059
41320,c,ê_çÈåS,16434,16405,29,0.176775373,43.99,373.6,5890,5478,412,7.520993063
41327,3,ãgñÏÉñó¢í¨,16434,16405,29,0.176775373,43.99,373.6,5890,5478,412,7.520993063
41340,c,éOó{äÓåS,52086,53236,-1150,-2.160192351,86.86,599.7,18181,17536,645,3.67814781
41341,3,äÓéRí¨,17494,17837,-343,-1.922969109,22.15,789.8,6294,6025,269,4.464730291
41345,3,è„ïÙí¨,9296,9224,72,0.78057242,12.8,726.3,3263,3074,189,6.148340924
41346,3,Ç›Ç‚Ç´í¨,25296,26175,-879,-3.358166189,51.92,487.2,8624,8437,187,2.21642764
41380,c,ìåèºâYåS,5904,6379,-475,-7.446308199,35.9,164.5,1917,1959,-42,-2.143950995
41387,3,å∫äCí¨,5904,6379,-475,-7.446308199,35.9,164.5,1917,1959,-42,-2.143950995
41400,c,êºèºâYåS,20166,20929,-763,-3.645659133,65.85,306.2,6896,6916,-20,-0.2891845
41401,3,óLìcí¨,20166,20929,-763,-3.645659133,65.85,306.2,6896,6916,-20,-0.2891845
41420,c,ãnìáåS,40324,42491,-2167,-5.099903509,135.54,297.5,13046,13116,-70,-0.533699299
41423,3,ëÂí¨í¨,6782,7369,-587,-7.965802687,11.5,589.7,2561,2694,-133,-4.936896808
41424,3,ç]ñkí¨,9588,9515,73,0.767209669,24.49,391.5,3231,3076,155,5.039011704
41425,3,îíêŒí¨,23954,25607,-1653,-6.455266138,99.56,240.6,7254,7346,-92,-1.252382249
41440,c,ì°í√åS,8782,9842,-1060,-10.77016866,74.3,118.2,2902,2925,-23,-0.786324786
41441,3,ëæó«í¨,8782,9842,-1060,-10.77016866,74.3,118.2,2902,2925,-23,-0.786324786
42000,a,í∑çËåß,1377780,1426779,-48999,-3.43423894,4132.32,333.4,560681,558660,2021,0.361758494
42001,b,ésïî,1232255,1276831,-44576,-3.491143307,3643.26,338.2,505217,503933,1284,0.254795776
42002,b,åSïî,145525,149948,-4423,-2.949689226,489.05,297.6,55464,54727,737,1.346684452
42201,2,í∑çËés,429644,443766,-14122,-3.182307793,405.81,1058.7,189422,187685,1737,0.925486853
42202,2,ç≤ê¢ï€és,255648,261101,-5453,-2.088463851,426.06,600,104998,104583,415,0.396814014
42203,2,ìáå¥és,45426,47455,-2029,-4.275629544,82.97,547.5,17083,17039,44,0.258231117
42204,2,Ê|ëÅés,138136,140752,-2616,-1.858588155,341.83,404.1,51842,50989,853,1.672909843
42205,2,ëÂë∫és,92812,90517,2295,2.535435333,126.66,732.8,36080,34044,2036,5.980495829
42207,2,ïΩåÀés,31949,34905,-2956,-8.468700759,235.2,135.8,12388,12885,-497,-3.857198293
42208,2,èºâYés,23344,25145,-1801,-7.162457745,130.67,178.6,8974,9214,-240,-2.60473193
42209,2,ëŒînés,31468,34407,-2939,-8.541866481,708.63,44.4,13393,13813,-420,-3.040613914
42210,2,àÎäÚés,27106,29377,-2271,-7.730537495,139.42,194.4,10096,10401,-305,-2.932410345
42211,2,å‹ìáés,37331,40622,-3291,-8.101521343,420.04,88.9,17422,18382,-960,-5.222500272
42212,2,êºäCés,28692,31176,-2484,-7.967667437,241.59,118.8,11504,11875,-371,-3.124210526
42213,2,â_êÂés,44135,47245,-3110,-6.582707165,214.27,206,15361,15863,-502,-3.164596861
42214,2,ìÏìáå¥és,46564,50363,-3799,-7.543236106,170.11,273.7,16654,17160,-506,-2.948717949
42300,c,êºîﬁãnåS,72376,72645,-269,-0.370293895,49.67,1457.1,27353,26265,1088,4.142394822
42307,3,í∑ó^í¨,42562,42535,27,0.063477137,28.73,1481.4,16228,15478,750,4.845587285
42308,3,éûí√í¨,29814,30110,-296,-0.983062106,20.94,1423.8,11125,10787,338,3.133401316
42320,c,ìåîﬁãnåS,37238,38781,-1543,-3.978752482,167.63,222.1,12810,12671,139,1.096993134
42321,3,ìåîﬁãní¨,8301,8903,-602,-6.761765697,74.29,111.7,2741,2747,-6,-0.218420095
42322,3,êÏíIí¨,14072,14651,-579,-3.951948672,37.34,376.9,5108,5144,-36,-0.699844479
42323,3,îgç≤å©í¨,14865,15227,-362,-2.377356012,56,265.4,4961,4780,181,3.786610879
42380,c,ñkèºâYåS,16189,16448,-259,-1.574659533,57.8,280.1,6312,6171,141,2.284880895
42383,3,è¨ílâÍí¨,2560,2849,-289,-10.14391014,25.53,100.3,1210,1287,-77,-5.982905983
42391,3,ç≤ÅXí¨,13629,13599,30,0.220604456,32.27,422.3,5102,4884,218,4.463554464
42400,c,ìÏèºâYåS,19722,22074,-2352,-10.65506931,213.94,92.2,8989,9620,-631,-6.559251559
42411,3,êVè„å‹ìáí¨,19722,22074,-2352,-10.65506931,213.94,92.2,8989,9620,-631,-6.559251559
43000,a,åFñ{åß,1786969,1817426,-30457,-1.675831643,7409.32,241.2,704497,688234,16263,2.363004443
43001,b,ésïî,1440748,1461794,-21046,-1.439737747,3735.11,385.7,578278,564185,14093,2.497939506
43002,b,åSïî,346221,355632,-9411,-2.646274801,3674.21,94.2,126219,124049,2170,1.749308741
43100,1,åFñ{és,741115,734474,6641,0.904184491,390.32,1898.7,315470,302413,13057,4.317605394
43101,0,åFñ{és íÜâõãÊ,186264,184353,1911,1.036598265,25.45,7318.8,95766,92242,3524,3.820385508
43102,0,åFñ{és ìåãÊ,190480,188082,2398,1.274975808,50.19,3795.2,78326,74942,3384,4.515491981
43103,0,åFñ{és êºãÊ,93178,93805,-627,-0.668407867,89.33,1043.1,38978,37610,1368,3.637330497
43104,0,åFñ{és ìÏãÊ,127981,122600,5381,4.389070147,110.01,1163.4,47199,43499,3700,8.505942665
43105,0,åFñ{és ñkãÊ,143212,145634,-2422,-1.663073184,115.34,1241.7,55201,54120,1081,1.997413156
43202,2,î™ë„és,127540,132266,-4726,-3.573102687,681.36,187.2,47823,47458,365,0.7691011
43203,2,êlãgés,33891,35611,-1720,-4.829968268,210.55,161,13831,14001,-170,-1.214198986
43204,2,çrîˆés,53453,55321,-1868,-3.376656243,57.37,931.7,20901,20898,3,0.014355441
43205,2,êÖñìés,25418,26978,-1560,-5.782489436,163.29,155.7,10638,10893,-255,-2.340952906
43206,2,ã ñºés,66802,69541,-2739,-3.938683654,152.6,437.8,24477,24344,133,0.546335853
43208,2,éRé≠és,52278,55391,-3113,-5.620046578,299.69,174.4,19140,19308,-168,-0.870105656
43210,2,ãeírés,48209,50194,-1985,-3.954655935,276.85,174.1,16959,16706,253,1.514425955
43211,2,âFìyés,37053,37727,-674,-1.786518939,74.3,498.7,13284,12808,476,3.716427233
43212,2,è„ìVëêés,26998,29902,-2904,-9.711724968,126.91,212.7,10472,10994,-522,-4.748044388
43213,2,âFèÈés,59781,61878,-2097,-3.388926598,188.6,317,21434,21077,357,1.693789439
43214,2,à¢ëhés,27038,28444,-1406,-4.943045985,376.3,71.9,10048,10100,-52,-0.514851485
43215,2,ìVëêés,82770,89065,-6295,-7.067871779,683.78,121,33227,34272,-1045,-3.049136321
43216,2,çáéués,58402,55002,3400,6.181593397,53.19,1098,20574,18913,1661,8.78231904
43340,c,â∫âvèÈåS,10341,11388,-1047,-9.193888304,144,71.8,3611,3791,-180,-4.748087576
43348,3,î¸ó¢í¨,10341,11388,-1047,-9.193888304,144,71.8,3611,3791,-180,-4.748087576
43360,c,ã ñºåS,41152,43959,-2807,-6.385495575,211.46,194.6,15051,15181,-130,-0.856333575
43364,3,ã ìåí¨,5264,5554,-290,-5.221462009,24.33,216.4,1825,1825,0,0
43367,3,ìÏä÷í¨,9790,10564,-774,-7.326770163,68.92,142,3576,3681,-105,-2.852485738
43368,3,í∑èFí¨,15900,16594,-694,-4.182234543,19.43,818.3,6138,6051,87,1.43777888
43369,3,òaêÖí¨,10198,11247,-1049,-9.326931626,98.78,103.2,3512,3624,-112,-3.090507726
43400,c,ãeíråS,74476,68968,5508,7.986312493,136.56,545.4,28656,25602,3054,11.92875557
43403,3,ëÂí√í¨,33480,31234,2246,7.190881731,99.1,337.8,12703,11478,1225,10.67259104
43404,3,ãeózí¨,40996,37734,3262,8.644723592,37.46,1094.4,15953,14124,1829,12.94958935
43420,c,à¢ëhåS,37393,39392,-1999,-5.074634444,703.25,53.2,14441,14507,-66,-0.454952781
43423,3,ìÏè¨çëí¨,4051,4429,-378,-8.534657936,115.9,35,1642,1702,-60,-3.525264395
43424,3,è¨çëí¨,7188,7877,-689,-8.746984893,136.94,52.5,2791,2875,-84,-2.92173913
43425,3,éYéRë∫,1510,1606,-96,-5.97758406,60.81,24.8,534,575,-41,-7.130434783
43428,3,çÇêXí¨,6327,6716,-389,-5.792138178,175.06,36.1,2458,2524,-66,-2.614896989
43432,3,êºå¥ë∫,6805,6792,13,0.191401649,77.22,88.1,2341,2221,120,5.402971634
43433,3,ìÏà¢ëhë∫,11512,11972,-460,-3.842298697,137.32,83.8,4675,4610,65,1.409978308
43440,c,è„âvèÈåS,85814,87402,-1588,-1.816892062,783.96,109.5,30212,29688,524,1.765022905
43441,3,å‰ëDí¨,17243,17888,-645,-3.605769231,99.03,174.1,6307,6224,83,1.333547558
43442,3,â√ìáí¨,9057,8676,381,4.39142462,16.65,544,3171,2930,241,8.225255973
43443,3,âvèÈí¨,33632,32676,956,2.9256947,65.68,512.1,11438,10935,503,4.599908551
43444,3,çbç≤í¨,10718,11181,-463,-4.140953403,57.93,185,3704,3693,11,0.297860818
43447,3,éRìsí¨,15164,16981,-1817,-10.70019433,544.67,27.8,5592,5906,-314,-5.316627159
43460,c,î™ë„åS,12001,12715,-714,-5.615414864,33.36,359.7,3873,3973,-100,-2.51698968
43468,3,ïXêÏí¨,12001,12715,-714,-5.615414864,33.36,359.7,3873,3973,-100,-2.51698968
43480,c,àØñkåS,22346,24378,-2032,-8.335384363,268.07,83.4,8229,8622,-393,-4.558107168
43482,3,à∞ñkí¨,17668,19316,-1648,-8.53178712,233.97,75.5,6484,6796,-312,-4.590935845
43484,3,í√ìﬁñÿí¨,4678,5062,-384,-7.585934413,34.09,137.2,1745,1826,-81,-4.43592552
43500,c,ãÖñÅåS,54957,59116,-4159,-7.035320387,1326.02,41.4,19252,19683,-431,-2.189706854
43501,3,ã—í¨,10774,11075,-301,-2.717832957,85.04,126.7,3630,3602,28,0.777345919
43505,3,ëΩó«ñÿí¨,9798,10554,-756,-7.163160887,165.86,59.1,3535,3614,-79,-2.185943553
43506,3,ìíëOí¨,3990,4375,-385,-8.8,48.37,82.5,1479,1515,-36,-2.376237624
43507,3,êÖè„ë∫,2232,2405,-173,-7.193347193,190.96,11.7,822,854,-32,-3.7470726
43510,3,ëäó«ë∫,4461,4934,-473,-9.586542359,94.54,47.2,1506,1529,-23,-1.504251145
43511,3,å‹ñÿë∫,1046,1205,-159,-13.19502075,252.92,4.1,468,503,-35,-6.958250497
43512,3,éRç]ë∫,3424,3681,-257,-6.981798424,121.19,28.3,1149,1163,-14,-1.203783319
43513,3,ãÖñÅë∫,3700,4249,-549,-12.92068722,207.58,17.8,1368,1489,-121,-8.126259234
43514,3,Ç†Ç≥Ç¨ÇËí¨,15532,16638,-1106,-6.647433586,159.56,97.3,5295,5414,-119,-2.198005172
43520,c,ìVëêåS,7741,8314,-573,-6.891989415,67.55,114.6,2894,3002,-108,-3.597601599
43531,3,óËñkí¨,7741,8314,-573,-6.891989415,67.55,114.6,2894,3002,-108,-3.597601599
44000,a,ëÂï™åß,1166729,1196529,-29800,-2.490537212,6340.61,184,485909,482051,3858,0.800330256
44001,b,ésïî,1111180,1138644,-27464,-2.411991808,5702.41,194.9,464690,460871,3819,0.828648364
44002,b,åSïî,55549,57885,-2336,-4.035587803,638.2,87,21219,21180,39,0.184135977
44201,2,ëÂï™és,478335,474094,4241,0.894548339,502.39,952.1,203286,195623,7663,3.917228547
44202,2,ï ï{és,122193,125385,-3192,-2.545759062,125.29,975.3,55467,56070,-603,-1.075441413
44203,2,íÜí√és,83967,84312,-345,-0.409194421,491.54,170.8,35789,34574,1215,3.514201423
44204,2,ì˙ìcés,66526,70940,-4414,-6.222159572,666.03,99.9,25135,25551,-416,-1.628116316
44205,2,ç≤îåés,72203,76951,-4748,-6.170160232,903.08,80,29575,30511,-936,-3.067746059
44206,2,âPãnés,38768,41469,-2701,-6.513299091,291.2,133.1,15050,15394,-344,-2.234636872
44207,2,í√ãvå©és,17973,19917,-1944,-9.7605061,79.47,226.2,7516,7978,-462,-5.790925044
44208,2,í|ìcés,22342,24423,-2081,-8.520656758,477.53,46.8,9133,9588,-455,-4.745515227
44209,2,ñLå„çÇìcés,22868,23906,-1038,-4.342006191,206.24,110.9,9539,9665,-126,-1.303673047
44210,2,ãnízés,30204,32083,-1879,-5.856684225,280.06,107.8,12141,12181,-40,-0.328380264
44211,2,âFç≤és,56277,59008,-2731,-4.628186009,439.05,128.2,22450,22869,-419,-1.832174559
44212,2,ñLå„ëÂñÏés,36598,39452,-2854,-7.23410727,603.14,60.7,14223,14854,-631,-4.248014003
44213,2,óRïzés,34276,34702,-426,-1.227594951,319.32,107.3,13284,12874,410,3.184713376
44214,2,çëìåés,28650,32002,-3352,-10.47434535,318.07,90.1,12102,13139,-1037,-7.892533678
44320,c,ìåçëìååS,1992,2189,-197,-8.99954317,6.98,285.4,877,913,-36,-3.943044907
44322,3,ïPìáë∫,1992,2189,-197,-8.99954317,6.98,285.4,877,913,-36,-3.943044907
44340,c,ë¨å©åS,28067,28221,-154,-0.545692924,73.33,382.7,10893,10517,376,3.57516402
44341,3,ì˙èoí¨,28067,28221,-154,-0.545692924,73.33,382.7,10893,10517,376,3.57516402
44460,c,ãËéÏåS,25490,27475,-1985,-7.224749773,557.88,45.7,9449,9750,-301,-3.087179487
44461,3,ã„èdí¨,9659,10421,-762,-7.312158142,271.37,35.6,3471,3601,-130,-3.610108303
44462,3,ãËéÏí¨,15831,17054,-1223,-7.171338103,286.51,55.3,5978,6149,-171,-2.78093999
45000,a,ã{çËåß,1104377,1135233,-30856,-2.718032334,7735.31,142.8,462620,460505,2115,0.459278401
45001,b,ésïî,922641,945222,-22581,-2.388962593,4617.92,199.8,392426,389733,2693,0.69098588
45002,b,åSïî,181736,190011,-8275,-4.355011026,3117.39,58.3,70194,70772,-578,-0.816707172
45201,2,ã{çËés,401156,400583,573,0.143041517,643.67,623.2,175360,170136,5224,3.070484789
45202,2,ìsèÈés,165098,169602,-4504,-2.655629061,653.36,252.7,69934,69856,78,0.111658268
45203,2,âÑâ™és,125212,131182,-5970,-4.550929243,868.02,144.3,51710,52454,-744,-1.418385633
45204,2,ì˙ìÏés,54124,57689,-3565,-6.179687635,536.1,101,22644,23228,-584,-2.514206992
45205,2,è¨ó—és,46245,48270,-2025,-4.195152269,562.95,82.1,19484,19576,-92,-0.46996322
45206,2,ì˙å¸és,61777,63223,-1446,-2.287142337,336.93,183.4,24780,24791,-11,-0.044370941
45207,2,ã¯ä‘és,18787,20453,-1666,-8.145504327,295.16,63.7,7946,8417,-471,-5.595817987
45208,2,êºìsés,30704,32614,-1910,-5.856380695,438.79,70,12002,12197,-195,-1.598753792
45209,2,Ç¶Ç—ÇÃés,19538,21606,-2068,-9.571415348,282.93,69.1,8566,9078,-512,-5.640008813
45340,c,ñkèîåßåS,25410,24800,610,2.459677419,110.02,231,9967,9503,464,4.882668631
45341,3,éOå“í¨,25410,24800,610,2.459677419,110.02,231,9967,9503,464,4.882668631
45360,c,êºèîåßåS,9304,10000,-696,-6.96,85.39,109,3914,4042,-128,-3.166749134
45361,3,çÇå¥í¨,9304,10000,-696,-6.96,85.39,109,3914,4042,-128,-3.166749134
45380,c,ìåèîåßåS,26957,28133,-1176,-4.180144315,225.82,119.4,10500,10597,-97,-0.915353402
45382,3,çëïxí¨,19608,20909,-1301,-6.222200966,130.63,150.1,7562,7746,-184,-2.375419571
45383,3,àªí¨,7349,7224,125,1.7303433,95.19,77.2,2938,2851,87,3.051560856
45400,c,éôìíåS,71265,74389,-3124,-4.199545632,715.03,99.7,27389,27569,-180,-0.652907251
45401,3,çÇìÁí¨,21039,21733,-694,-3.193300511,43.8,480.3,8675,8668,7,0.080756807
45402,3,êVïxí¨,17388,18092,-704,-3.89122264,61.53,282.6,6376,6362,14,0.220056586
45403,3,êºïƒó«ë∫,1089,1241,-152,-12.24818695,271.51,4,509,598,-89,-14.88294314
45404,3,ñÿèÈí¨,5231,5177,54,1.04307514,145.96,35.8,1958,1897,61,3.215603585
45405,3,êÏìÏí¨,16116,17009,-893,-5.250161679,90.12,178.8,5930,6020,-90,-1.495016611
45406,3,ìsî_í¨,10402,11137,-735,-6.599622879,102.11,101.9,3941,4024,-83,-2.062624255
45420,c,ìåâPãnåS,28204,30076,-1872,-6.224231946,1294.2,21.8,10986,11278,-292,-2.589111545
45421,3,ñÂêÏí¨,18172,18854,-682,-3.617269545,120.51,150.8,6840,6840,0,0
45429,3,èîíÀë∫,1740,1882,-142,-7.545164718,187.56,9.3,689,719,-30,-4.172461752
45430,3,í≈ótë∫,2808,3092,-284,-9.184993532,537.29,5.2,1128,1203,-75,-6.234413965
45431,3,î¸ãΩí¨,5484,6248,-764,-12.22791293,448.84,12.2,2329,2516,-187,-7.432432432
45440,c,êºâPãnåS,20596,22613,-2017,-8.91964799,686.93,30,7438,7783,-345,-4.432738019
45441,3,çÇêÁï‰í¨,12759,13723,-964,-7.024703053,237.54,53.7,4668,4794,-126,-2.628285357
45442,3,ì˙îVâeí¨,3947,4463,-516,-11.56172978,277.67,14.2,1493,1621,-128,-7.896360271
45443,3,å‹Éñê£í¨,3890,4427,-537,-12.13011068,171.73,22.7,1277,1368,-91,-6.652046784
46000,a,é≠éôìáåß,1648752,1706242,-57490,-3.369393087,9188.1,179.4,724566,729386,-4820,-0.660829794
46001,b,ésïî,1459672,1501224,-41552,-2.767874748,5957.05,245,640419,640695,-276,-0.04307822
46002,b,åSïî,189080,205018,-15938,-7.773951556,3231.05,58.5,84147,88691,-4544,-5.123405983
46201,2,é≠éôìáés,600008,605846,-5838,-0.963611215,547.57,1095.8,270169,264686,5483,2.071511149
46203,2,é≠âÆés,103662,105070,-1408,-1.340059008,448.38,231.2,44932,44404,528,1.189082065
46204,2,ñççËés,22059,23638,-1579,-6.679922159,74.78,295,10074,10434,-360,-3.450258769
46206,2,à¢ãvç™és,21197,23154,-1957,-8.452103308,134.28,157.9,9194,9830,-636,-6.469989827
46208,2,èoêÖés,53778,55621,-1843,-3.313496701,329.98,163,22509,22555,-46,-0.20394591
46210,2,éwèhés,41843,44396,-2553,-5.750518065,148.84,281.1,18491,19210,-719,-3.74284227
46213,2,êºîVï\és,15958,16951,-993,-5.858061471,205.66,77.6,7356,7569,-213,-2.814110186
46214,2,êÇêÖés,15524,17248,-1724,-9.995361781,162.12,95.8,6984,7470,-486,-6.506024096
46215,2,éFñÄêÏì‡és,96109,99589,-3480,-3.494361827,682.94,140.7,40724,41449,-725,-1.749137494
46216,2,ì˙íués,49263,50822,-1559,-3.067569163,252.99,194.7,19649,19916,-267,-1.340630649
46217,2,ë]âóés,36570,39221,-2651,-6.759134137,390.11,93.7,16120,16859,-739,-4.383415386
46218,2,ñ∂ìáés,125900,127487,-1587,-1.244832807,603.18,208.7,54324,53971,353,0.654054955
46219,2,Ç¢ÇøÇ´ã¯ñÿñÏés,29290,31144,-1854,-5.952992551,112.3,260.8,12172,12315,-143,-1.161185546
46220,2,ìÏÇ≥Ç¬Ç‹és,35440,38704,-3264,-8.433236875,283.59,125,15365,16419,-1054,-6.419392168
46221,2,éuïzéués,31490,33034,-1544,-4.673972271,290.28,108.5,13896,14149,-253,-1.788112234
46222,2,âÇî¸és,43184,46121,-2937,-6.368031916,308.25,140.1,19632,20114,-482,-2.396340857
46223,2,ìÏã„èBés,36384,39065,-2681,-6.862920773,357.91,101.7,15336,16069,-733,-4.561578194
46224,2,à…ç≤és,26804,29304,-2500,-8.531258531,392.56,68.3,12115,12798,-683,-5.336771371
46225,2,à¶ó«és,75209,74809,400,0.534695023,231.25,325.2,31377,30478,899,2.949668613
46300,c,é≠éôìáåS,1165,1075,90,8.372093023,132.54,8.8,615,638,-23,-3.605015674
46303,3,éOìáë∫,407,418,-11,-2.631578947,31.4,13,223,242,-19,-7.851239669
46304,3,è\ìáë∫,758,657,101,15.37290715,101.14,7.5,392,396,-4,-1.01010101
46380,c,éFñÄåS,22411,24109,-1698,-7.043012983,303.9,73.7,9708,9969,-261,-2.61811616
46392,3,Ç≥Ç¬Ç‹í¨,22411,24109,-1698,-7.043012983,303.9,73.7,9708,9969,-261,-2.61811616
46400,c,èoêÖåS,10436,11105,-669,-6.024313372,116.12,89.9,4138,4303,-165,-3.834534046
46404,3,í∑ìáí¨,10436,11105,-669,-6.024313372,116.12,89.9,4138,4303,-165,-3.834534046
46440,c,à¶ó«åS,10321,11595,-1274,-10.98749461,144.29,71.5,4322,4653,-331,-7.113690092
46452,3,óNêÖí¨,10321,11595,-1274,-10.98749461,144.29,71.5,4322,4653,-331,-7.113690092
46460,c,ë]âóåS,13248,14215,-967,-6.802673233,100.67,131.6,6079,6380,-301,-4.717868339
46468,3,ëÂçËí¨,13248,14215,-967,-6.802673233,100.67,131.6,6079,6380,-301,-4.717868339
46480,c,äÃëÆåS,37672,41764,-4092,-9.797912077,712.61,52.9,16807,18291,-1484,-8.113279755
46482,3,ìåã¯ó«í¨,6538,6802,-264,-3.881211408,27.78,235.3,2829,2964,-135,-4.55465587
46490,3,ã—ç]í¨,7920,8987,-1067,-11.87270502,163.19,48.5,3442,3804,-362,-9.516298633
46491,3,ìÏëÂã˜í¨,7545,8815,-1270,-14.40726035,213.54,35.3,3559,4005,-446,-11.1360799
46492,3,äÃïtí¨,15669,17160,-1491,-8.688811189,308.1,50.9,6977,7518,-541,-7.196062783
46500,c,åFñ—åS,26796,28503,-1707,-5.98884328,788.66,34,12597,13028,-431,-3.308259134
46501,3,íÜéÌéqí¨,8136,8696,-560,-6.43974241,137.82,59,3741,3946,-205,-5.195134313
46502,3,ìÏéÌéqí¨,5745,6218,-473,-7.606947572,110.36,52.1,2724,2834,-110,-3.881439661
46505,3,âÆãvìáí¨,12915,13589,-674,-4.959894032,540.48,23.9,6132,6248,-116,-1.85659411
46520,c,ëÂìáåS,67031,72652,-5621,-7.736882674,932.24,71.9,29881,31429,-1548,-4.925387381
46523,3,ëÂòaë∫,1529,1765,-236,-13.37110482,88.26,17.3,709,831,-122,-14.6811071
46524,3,âFåüë∫,1719,1932,-213,-11.02484472,103.07,16.7,866,935,-69,-7.379679144
46525,3,ê£åÀì‡í¨,9050,9874,-824,-8.345148876,239.63,37.8,4414,4677,-263,-5.623262775
46527,3,ó¥ãΩí¨,5809,6078,-269,-4.42579796,82.01,70.8,2414,2468,-54,-2.188006483
46529,3,äÏäEí¨,7213,8169,-956,-11.7027788,56.97,126.6,3364,3634,-270,-7.429829389
46530,3,ìøîVìáí¨,11164,12090,-926,-7.659222498,104.92,106.4,4959,5230,-271,-5.18164436
46531,3,ìVèÈí¨,5980,6653,-673,-10.11573726,80.4,74.4,2623,2841,-218,-7.673354453
46532,3,à…êÂí¨,6369,6844,-475,-6.940385739,62.71,101.6,2885,3035,-150,-4.942339374
46533,3,òaîëí¨,6790,7114,-324,-4.554399775,40.39,168.1,2910,2909,1,0.034376074
46534,3,ímñºí¨,6218,6806,-588,-8.639435792,53.3,116.7,2680,2862,-182,-6.359189378
46535,3,ó^ò_í¨,5190,5327,-137,-2.571804017,20.58,252.2,2057,2007,50,2.491280518
47000,a,â´ìÍåß,1434138,1392818,41320,2.966647473,2281,628.7,559744,520191,39553,7.60355331
47001,b,ésïî,1110623,1078992,31631,2.931532393,976.09,1137.8,439486,409085,30401,7.431462899
47002,b,åSïî,323515,313826,9689,3.087379631,1304.74,248,120258,111106,9152,8.23717891
47201,2,ìﬂîeés,319449,315954,3495,1.106173684,39.57,8073,135094,129512,5582,4.310025326
47205,2,ãXñÏòpés,96297,91928,4369,4.752632495,19.8,4863.5,39297,36361,2936,8.074585407
47207,2,êŒä_és,47660,46922,738,1.572822983,229.27,207.9,20532,19212,1320,6.870705809
47208,2,âYìYés,114285,110351,3934,3.564988084,19.48,5866.8,44027,40927,3100,7.574461847
47209,2,ñºåÏés,61711,60231,1480,2.457206422,210.9,292.6,26144,24277,1867,7.690406558
47210,2,éÖñûés,58557,57320,1237,2.158060014,46.62,1256,20583,19249,1334,6.930230142
47211,2,â´ìÍés,139315,130249,9066,6.960514092,49.72,2802,53360,47999,5361,11.16898269
47212,2,ñLå©èÈés,61128,57261,3867,6.753287578,19.6,3118.8,21771,19332,2439,12.61638734
47213,2,Ç§ÇÈÇ‹és,119019,116979,2040,1.743902752,87.01,1367.9,42389,38344,4045,10.54923847
47214,2,ã{å√ìáés,51196,52039,-843,-1.619938892,204.18,250.7,21965,21196,769,3.628043027
47215,2,ìÏèÈés,42006,39758,2248,5.654207958,49.94,841.1,14324,12676,1648,13.00094667
47300,c,çëì™åS,64581,64608,-27,-0.04179049,577.21,111.9,25390,24401,989,4.053112577
47301,3,çëì™ë∫,4922,5188,-266,-5.127216654,194.8,25.3,2064,2114,-50,-2.365184484
47302,3,ëÂãXñ°ë∫,3060,3221,-161,-4.998447687,63.55,48.2,1261,1267,-6,-0.47355959
47303,3,ìåë∫,1721,1794,-73,-4.069119287,81.88,21,793,691,102,14.76121563
47306,3,ç°ãAêmë∫,9527,9257,270,2.916711678,39.93,238.6,3468,3368,100,2.96912114
47308,3,ñ{ïîí¨,13549,13870,-321,-2.314347513,54.33,249.4,5239,5049,190,3.76312141
47311,3,â∂î[ë∫,10679,10144,535,5.274053628,50.82,210.1,4028,3801,227,5.972112602
47313,3,ãXñÏç¿ë∫,5597,5331,266,4.989682986,31.3,178.8,2001,1823,178,9.764125069
47314,3,ã‡ïêí¨,11264,11066,198,1.789264414,37.84,297.7,4649,4373,276,6.311456666
47315,3,à…ç]ë∫,4262,4737,-475,-10.02744353,22.78,187.1,1887,1915,-28,-1.462140992
47320,c,íÜì™åS,151655,147688,3967,2.686067927,107.31,1413.2,54741,50868,3873,7.613824015
47324,3,ì«íJë∫,39493,38200,1293,3.384816754,35.28,1119.4,13640,12422,1218,9.80518435
47325,3,â√éËî[í¨,13708,13827,-119,-0.86063499,15.12,906.6,5069,4937,132,2.673688475
47326,3,ñkíJí¨,28329,27264,1065,3.90625,13.93,2033.7,10709,9903,806,8.138947794
47327,3,ñkíÜèÈë∫,16163,15951,212,1.329070278,11.54,1400.6,5538,5220,318,6.091954023
47328,3,íÜèÈë∫,19452,17680,1772,10.02262443,15.53,1252.5,7196,6268,928,14.80536056
47329,3,êºå¥í¨,34510,34766,-256,-0.736351608,15.9,2170.4,12589,12118,471,3.886779997
47340,c,ìáêKåS,100245,94783,5462,5.76263676,234.88,426.8,36463,32625,3838,11.76398467
47348,3,ó^ìﬂå¥í¨,18429,16318,2111,12.93663439,5.18,3557.7,7021,5805,1216,20.94745909
47350,3,ìÏïóå¥í¨,37518,35244,2274,6.45216207,10.76,3486.8,12711,11254,1457,12.94650791
47353,3,ìnâ√ï~ë∫,731,760,-29,-3.815789474,19.23,38,417,429,-12,-2.797202797
47354,3,ç¿ä‘ñ°ë∫,870,865,5,0.578034682,16.74,52,446,459,-13,-2.832244009
47355,3,àæçëë∫,710,863,-153,-17.72885284,7.65,92.8,385,379,6,1.583113457
47356,3,ìnñºäÏë∫,430,452,-22,-4.867256637,3.87,111.1,267,246,21,8.536585366
47357,3,ìÏëÂìåë∫,1329,1442,-113,-7.836338419,30.53,43.5,685,713,-28,-3.927068724
47358,3,ñkëÂìåë∫,629,665,-36,-5.413533835,13.09,48.1,333,378,-45,-11.9047619
47359,3,à…ïΩâÆë∫,1238,1385,-147,-10.61371841,21.82,56.7,511,523,-12,-2.294455067
47360,3,à…ê•ñºë∫,1516,1589,-73,-4.59408433,15.42,98.3,696,699,-3,-0.429184549
47361,3,ãvïƒìáí¨,7761,8519,-758,-8.897757953,63.65,121.9,3359,3601,-242,-6.720355457
47362,3,î™èdê£í¨,29084,26681,2403,9.006409055,26.96,1078.8,9632,8139,1493,18.34377688
47370,c,ã{å√åS,1196,1231,-35,-2.843216897,21.99,54.4,468,499,-31,-6.21242485
47375,3,ëΩó«ä‘ë∫,1196,1231,-35,-2.843216897,21.99,54.4,468,499,-31,-6.21242485
47380,c,î™èdéRåS,5838,5516,322,5.837563452,363.35,16.1,3196,2713,483,17.80316992
47381,3,í|ïxí¨,3995,3859,136,3.524229075,334.39,11.9,2116,2000,116,5.8
47382,3,ó^ìﬂçëí¨,1843,1657,186,11.22510561,28.96,63.6,1080,713,367,51.47265077
